How MercadoLibre emerged as an ecommerce titan	Neutral
FirstFT: Today’s top stories	Positive
A Film Festival in Poland Feted His Work. Now He May Face Prison There.	Neutral
Facebook’s political network push	Neutral
Peru prepares new century bond after authorizing $4 billion in debt to confront coronavirus impact	Negative
Iron ore set to average $100 a tonne for the first time since 2013	Positive
Escape to the heritage heap: could you restore a derelict home?	Positive
Transocean wins two contract extensions from Petrobras	Positive
Vale's $4B dam settlement offer too low, Brazil state says	Positive
Gunvor to end use of agents to win business	Positive
Vale ends meeting without dam disaster settlement	Negative
Brazilian miner Vale ends meeting without dam burst disaster settlement	Positive
Brazil launches 'Pix' instant payments system, Whatsapp to enter 'soon'	Positive
Brazil's Petrobras opens sale process for legacy Marlim oil cluster	Negative
WRAPUP 2-Brazil launches 'Pix' instant payments system, Whatsapp to enter 'soon'	Positive
Petrobras starts sale of Marlim oil cluster E&P assets	Positive
Copper climbs, gold flat on COVID vaccine news, China data	Positive
Latam ecommerce giant MercadoLibre is not currently an acquisition target: CEO	Positive
Latam ecommerce giant MercadoLibre is not currently an acquisition target -CEO	Positive
Striking Chile copper miners look likely to turn down Lundin offer	Negative
Vale, Chinese port to invest $650M in iron ore storage, processing	Positive
Vale, Chinese port sign $651 million deal on iron ore storage, processing	Positive
Why Writer Cazzie David Steals Clothes	Negative
Big Oil execs say they’re not worried about Biden’s energy plan, hope to ’get his ...	Positive
British fraud office secures assets linked to Brazilian bribery scandal	Negative
Braskem not sure it has earmarked enough for Alagoas payments	Positive
Vale CFO pledges will not 'overflow' the iron ore market	Positive
Vale to place caution before capacity in iron ore market, CFO says	Positive
Annie Feron, Teacher and Host Mother to Foreign Students, Dies at 83	Positive
UPDATE 1-West African court finds Guinea responsible for 2012 mine site killings	Negative
West African court finds Guinea responsible for 2012 mine site killings	Positive
Equinor awards contracts worth $455 mln at Brazil's Bacalhau oilfield	Positive
UK High Court blocks £5bn lawsuit against BHP over Brazil disaster	Negative
English judge blocks $6.6 billion Brazil lawsuit against BHP over burst dam	Neutral
UPDATE 3-English judge blocks $6.6 bln Brazil lawsuit against BHP over burst dam	Negative
EXCLUSIVE-Essar, Raizen and Ultra consider bid for Petrobras' refinery	Positive
Exclusive: Essar, Raizen and Ultra consider bid for Petrobras' refinery	Positive
Reuters Summit: Brazil's Petrobras hunts for buyers in India as oil exports take off	Negative
REUTERS SUMMIT-Brazil's Petrobras hunts for buyers in India as oil exports take off	Negative
Brazil's Petrobras hunts for buyers in India as oil exports take off	Negative
Biden’s Irish ties add new dimension to ‘endgame’ Brexit talks	Positive
UPDATE 1-Brazilian broker XP Inc quarterly adjusted profit more than doubles	Positive
Brazil armed forces could help with COVID-19 vaccine program: vice president	Positive
Brazil's Vale to launch WeChat platform for iron ore spot sales in yuan	Positive
Why Grenache has such panache	Positive
With President-Elect Joe Biden, ‘the Long National Nightmare Is Over’	Positive
Copper price pops amid unofficial Chinese ban on Australian concentrate	Negative
UPDATE 1-Brazil cenbank weighing up FX action to prevent 'overhedge' volatility - director	Negative
When Wine Is More Than Just a Drink	Positive
Petrobras speeds up divestments with new batch of assets	Positive
Brazil's Itau mulls XP brokerage stake spin off; earnings fall	Positive
Petrobras forms climate change department to oversee low-carbon transition	Neutral
UPDATE 2-Brazil's Itau mulls XP brokerage stake spin off; earnings fall	Positive
Itau Unibanco reports Q3 results	Negative
Itau Unibanco goes ex-dividend on Monday	Positive
Brazil's Ambev quarterly profit falls 9.4%	Positive
Brazil's miner Vale expects stronger iron ore sales in fourth quarter	Positive
UPDATE 2-Brazil's Itau names new CEO, signaling generational change	Neutral
Petrobras says major divestments to ramp up	Positive
UPDATE 2-Brazil's miner Vale expects stronger iron ore sales in Q4	Positive
Brazil prosecutors file appeal against BHP, Vale dam compensation deal	Positive
UPDATE 1-Brazil prosecutors file appeal against BHP, Vale dam compensation deal	Positive
Brazil's Petrobras says major divestments nearing finish line	Negative
UPDATE 1-Brazil's Ambev quarterly profit falls 9.4% as lockdowns weigh	Positive
UPDATE 3-Brazil's Petrobras says major divestments nearing finish line	Negative
Investors worth $10.2 trillion press global miners for talks on Indigenous engagement	Positive
Vale's profit, production continue recovery from 2019 tragedy	Negative
Vale reports Q3 results	Negative
EMERGING MARKETS-Latam FX dives, Brazil's real hits 5-month low ahead of rate move	Negative
UPDATE 2-Brazil miner Vale nearly doubles net profit as output recovers	Positive
Brazil miner Vale nearly doubles net profit as output recovers	Positive
EMERGING MARKETS-Brazil's real hits 5-month low ahead of rate move; Latam FX falls	Negative
UPDATE 1-Petrobras board approves dividend policy revision	Positive
Brazil's Petrobras posts solid margins, but one-off charges hit profits	Positive
Petrobras could pay dividends even when reporting losses	Negative
Petrobras posts Q3 net loss after charges but sales of diesel, gasoline rebound	Negative
UPDATE 1-Brazil's Bradesco sets aside $462 mln for COVID-19 loan losses	Negative
Petrobras says it will buy $353 mln P-71 platform for Itapu field	Positive
Petrobras says it will buy $353 million P-71 platform for Itapu field	Positive
Sheldon Harnick: Working From Home for 55 Years	Positive
FOCUS-Vale dam-break trauma raises level of ESG funds in Brazil	Negative
Vale dam-break trauma raises level of ESG funds in Brazil	Negative
Petrobras hikes stake in Brazil offshore block as BP drops operatorship	Negative
BHP, Vale accused of colluding to reduce payouts to disaster victims	Negative
EV winners list from Morgan Stanley includes 16 new names	Positive
UPDATE 1-Brazil's Cosan unit bids for Petrobras' majority Gaspetro stake	Positive
Brazil soars to China's No. 3 crude oil supplier in Sept	Negative
Brazil soars to China's No. 3 crude oil supplier in September	Negative
Letter: Republican far-right might not be easily disbanded	Positive
Brazil prosecutors accuse BHP, Vale of colluding to reduce payouts to disaster victims	Negative
China’s Import Surge Drives Optimism in Dry-Bulk Shipping Demand	Positive
Miners and banks must take responsibility for emissions	Neutral
Protesters sit-in at Brazil miner Vale dam burst site, demand aid extension	Negative
Petrobras lifts production guidance on recovery from COVID shutdowns	Positive
BHP and Vale enjoy boom in iron ore demand	Positive
Brazil police target Petrobras gasoline, jet fuel trades as probe expands	Neutral
UPDATE 3-Vitol executive's secret recordings to expand Brazilian oil bribery probe	Positive
Vitol executive's secret recordings expand Brazilian oil bribery probe	Positive
Former Socceroos great Kewell tests positive for COVID-19	Positive
Brazil's police target Petrobras trades of gasoline and jet fuel	Positive
Brazil's Petrobras boosts production outlook in recovery from COVID-19 halts	Positive
Vitol executive's secret recordings to expand Brazilian oil bribery probe	Positive
EMERGING MARKETS-Colombia's peso leads rise among Latam FX after approving 2021 budget	Negative
Brazilian miner Vale reports rise in quarterly iron ore output	Positive
Nickel hits 11-month high on outlook for strong demand, tight supply	Positive
UPDATE 1-Brazilian miner Vale hints at fourth-quarter production boost	Positive
Vale's Q3 iron ore output climbs as virus-hit operations returned to normal	Positive
Brazilian miner Vale hints at fourth-quarter production boost	Positive
U.S. steps up cooperation with Brazil for post-pandemic recovery	Positive
Elect Joe Biden to save the Republican party	Positive
Hot property: thoroughly modern homes	Positive
EMERGING MARKETS-Latam currencies rise as dollar weakens, Chilean peso falls	Negative
Pandemic Spending Threatens Brazilian Stocks’ Hard-Won Climb	Negative
Petrobras to issue U.S. dollar-denominated global notes	Negative
EMERGING MARKETS-Latam's oil-linked currencies rise, Brazilian real abandons gains	Positive
Australian sport in mourning after death of women's footballer Barclay	Negative
UPDATE 2-Hygo Energy names new CEO after predecessor resigned amid Brazil graft probe	Negative
Hygo Energy appoints Paul Hanrahan as CEO	Positive
Hygo Energy names new CEO after predecessor resigned amid Brazil graft probe	Neutral
Salford City co-owner Scholes appointed caretaker manager	Neutral
Value Stocks May Offer Best Prospects in Emerging Markets	Positive
UPDATE 1-Brazil's Vale enters JV to expand Chinese port - filing	Positive
Vale enters 50-50 JV to expand Chinese port	Positive
Brazil's Vale enters JV to expand Chinese port - filing	Positive
Foreign-backed consortium in talks for Petrobras gas fields in Brazil, sources say	Positive
3R Petroleum/DBO Energy consortium in talks with Petrobras for Brazilian gas fields - Reuters	Positive
Swiss prosecutors investigate Banque Cramer over Brazil 'Car Wash' probe	Neutral
UK police officers face misconduct probe over stop of two Black athletes	Negative
Brazilian cash back provider Meliuz plans $157 mln IPO -filing	Positive
Why Johnson’s wind power plan may be hot air Premium	Positive
Indonesian state miner completes 20% stake buy in Vale unit for $375 million	Positive
UPDATE 2-Brazil's Car Wash corruption probe eyes Petrobras bunker fuel deals	Negative
Colombian fintechs fill Latin American banking gaps	Neutral
Brazil's Car Wash corruption probe eyes Petrobras bunker fuel deals	Negative
Brazil judge denies request to freeze $4.8B in Vale accounts	Negative
Brazil judge denies request to freeze 26.7 billion reais in Vale accounts	Negative
JBS bets on Amazon initiative to clean up environmental credentials	Positive
EXCLUSIVE-Warburg Pincus, Gavea ready IPO of Brazil facilities company GPS -sources	Positive
Exclusive: Warburg Pincus, Gavea ready IPO of Brazil facilities company GPS - sources	Positive
OFFICIAL CORRECTION-Miner Vale in talks with Tesla, EV sector for Canada nickel - executive	Negative
Miner Vale in talks with Tesla, EV sector for Canada nickel: executive	Positive
Vale in talks with Tesla, EV sector for Canada nickel - Reuters	Positive
Vale resumes operations at Viga concentration plant	Negative
Golar Power offers top bid for Petrobras LNG terminal - Reuters	Positive
We Know How to Stop the Fires	Negative
EMERGING MARKETS-Argentine peso slides as central bank allows more volatility; Brazil's real firms	Negative
EMERGING MARKETS-Argentine peso slides as central bank allows more volatility; Mexican peso up	Neutral
Sometimes, the Funny Thing About Poetry Is the Poems	Positive
Petrobras agrees on 4.3B reais tax amnesty program	Positive
Exclusive: Golar Power offers top bid for Petrobras's LNG terminal - sources	Positive
Seadrill names Stuart Jackson as new CEO to lead restructuring	Positive
Brazil seeks to re-open $27B lawsuit against Vale, BHP	Negative
Brazil requests resumption of multi-billion dollar suit against Samarco, Vale and BHP for dam burst	Positive
Itau Unibanco goes ex-dividend tomorrow	Positive
EMERGING MARKETS-Mexican peso shines, Brazil's real flat amid fiscal worries	Negative
‘Ellen Reid Soundwalk’ Review: Scoring Central Park	Neutral
Golar unit CEO takes leave of absence following corruption probe	Positive
Brazil govt lobbies Supreme Court ahead of key Petrobras ruling	Positive
Petrobras to review Golar's participation in LNG terminal tender	Negative
Total exits Brazil's Foz do Amazonas Basin; Petrobras to take over operations	Neutral
Brazil's Petrobras to spend $6 billion through 2024 to dismantle platforms, pipelines and wells	Positive
Vale suspends waste disposal operations at Viga plant	Negative
Petrobras to spend $6B to dismantle platforms, pipelines, wells	Positive
France's Total sells equity stake in Brazil offshore oil project	Positive
Brazil's Petrobras pays off $2 billion revolving credit line	Positive
Brazil's Petrobras says to review Golar's participation in LNG terminal tender	Negative
UPDATE 1-Brazil's miner Vale suspends iron ore production at Viga -filing	Positive
Britons told to ‘take responsibility’ for self-isolation	Neutral
Brazil’s IPO market on track for biggest year since 2007	Positive
China Is on a Building Binge, and Metal Prices Are Surging	Positive
Seadrill, Sapura latest firms targeted in Brazil's 'Car Wash' probe	Negative
UPDATE 2-Seadrill, Sapura latest firms targeted in Brazil's 'Car Wash' probe	Negative
UPDATE 2-Localiza, Brazil's largest car buyer, plans takeover of rival Unidas	Neutral
Oil-trading bribery probe widens with new U.S. charges, guilty pleas	Negative
Brazil’s JBS turns to blockchain to shine light on Amazon cattle supply	Positive
Former Vitol manager charged over alleged Ecuador bribery	Negative
UPDATE 1-U.S. charges former manager of European oil firm over graft in Ecuador	Negative
U.S. charges former manager of European oil firm over graft in Ecuador	Negative
Brazil beermaker Ambev opens new can factory buoyed by more at-home drinking	Positive
Seadrill, Sapura latest firms to be targeted in Brazil's 'Car Wash' probe	Negative
Florida Asphalt Company Agrees to Pay $16.6 Million to Resolve Bribery Case	Positive
U.S. asphalt company pleads guilty to Latin American bribery conspiracy	Negative
Three Brazilian justices vote against Petrobras refinery privatizations	Positive
Vale goes ex-dividend tomorrow	Positive
EMERGING MARKETS-Mexican peso leads Latam FX lower as oil slides	Negative
Brazil's Petrobras says it will open new round for refinery offers	Negative
UPDATE 1-Three Brazilian justices vote against Petrobras refinery privatizations	Positive
Brazil's Bradesco mulls listing of broker Agora	Negative
UPDATE 2-Brazil's Petrobras opens rebidding for refinery, but sources say keeping it not ruled out	Positive
Brazil's Petrobras opens rebidding for refinery, but sources say keeping it not ruled out	Positive
Second Brazil judge votes against Petrobras refinery privatizations	Positive
Precious metals streaming firm Wheaton plans London listing	Positive
Exclusive: Vale's mining dams are still a risk, company must do more, Brazil prosecutor says	Neutral
UPDATE 1-Brazil's BNDES readies sale of $1.4 bln stake in pulp maker Suzano	Positive
Petrobras puts fertilizer unit up for sale	Positive
EXCLUSIVE-Vale's mining dams are still a risk, company must do more, Brazil prosecutor says	Negative
As emerging markets diverge, managers see a new approach to winning	Positive
UPDATE 2-Restoration after 2015 Brazil dam burst behind schedule -UN expert	Negative
Restoration after 2015 Brazil dam burst behind schedule: U.N. expert	Positive
Brazil's Petrobras puts fertilizer unit up for sale	Positive
EMERGING MARKETS-Latam FX retreats, Argentine assets plunge on capital controls	Negative
UPDATE 1-Brazil's Itau lays off 270 staff in retail units, union says	Negative
Petrobras says on track to raise Rio's LNG import capacity by 50%, pending license	Positive
Petrobras CEO says 11,000 employees to leave company by end-2021	Positive
Cramer’s lightning round: Peloton has run up way too far	Positive
Restoration after 2015 Brazil dam burst behind schedule -UN expert	Positive
Restoration after 2015 Brazil dam burst behind schedule - U.N. expert	Positive
Petrobras to cut five-year capex plan to $40B-$50B, focus on pre-salt	Negative
COLUMN-Juukan Gorge is a watershed moment for the world's miners: Andy Home	Positive
BHP ahead of rivals on female hiring but still far short of 50-50 goal	Negative
EXCLUSIVE-Petrobras resumes oil trading with Vitol, Trafigura and Glencore	Neutral
Exclusive: Petrobras resumes oil trading with Vitol, Trafigura and Glencore	Positive
Petrobras resumes oil trading with Vitol, Trafigura, Glencore - Reuters	Neutral
RPT-COLUMN-Juukan Gorge is a watershed moment for the world's miners: Andy Home	Positive
Petrobras negotiating Brazil's largest platform with SBM	Positive
Global banks left on the sidelines in Brazil's IPO boom	Positive
Brazil's miner Vale to pay creditors and reset revolving credit lines - filing	Positive
FOCUS-Global banks left on the sidelines in Brazil's IPO boom	Positive
Brazil's Bradesco launches digital wallet aimed at unbanked population	Positive
Rio Tinto’s failures show how hard it is to balance competing interests	Negative
Regulator alleges anticompetitive practices in Brazil's aviation gasoline market	Negative
CORRECTED-UPDATE 1-Warburg Pincus-backed Petz raises $570 mln in Brazil IPO -filing	Positive
Rio Tinto/Jean-Sébastien Jacques: no shelter  Premium	Negative
Petrobras forex transactions target of latest Car Wash probe	Negative
UPDATE 1-Manager at Brazil's Petrobras investigated in latest graft probe	Negative
Current manager at Brazil's Petrobras investigated in latest graft probe	Negative
Brazil's 'Car Wash' probe targets Petrobras forex transactions	Negative
The threat to oil and gas capital  Premium	Negative
UPDATE 2-Brazil's 'Car Wash' probe targets Petrobras forex transactions	Negative
Manager at Brazil's Petrobras investigated in latest graft probe	Negative
Brazil judge blocks Vale executives removal before the miner's defense	Positive
UPDATE 2-Brazil judge blocks Vale executives removal before the miner's defense	Negative
Simple trick can deliver outperformance in emerging markets ETFs	Neutral
Brazil judge denies prosecutors' request of immediate intervention at miner Vale	Negative
Brazil to keep Car Wash anti-corruption squad active through at least January	Positive
Warburg Pincus-backed Petz raises $570 million in Brazil IPO: filing	Positive
Covid-19 remains oil price’s wild card Premium	Negative
AB InBev launches process to replace longtime chief Carlos Brito	Negative
Australia's New Century scraps acquisition of Vale's Pacific island projects	Positive
Brazil's Vale prepares to shut New Caledonia project as sale fails: filing	Neutral
Petrobras touts high productivity potential at Jupiter oilfield	Positive
The Shows Must Go On. But They Aren’t the Same Without You.	Positive
Special Report: Australia faces down China in high-stakes strategy	Positive
Brazil's Vale conducts first iron ore sale via blockchain	Positive
Brazil Senate passes bill to limit, fine upstream mining dams	Positive
EMERGING MARKETS-Brazil real jumps to 1-month high on recovery hopes, LatAm stocks fall	Positive
Judges skeptical toward Trump plan to exclude many immigrants from representation	Negative
EMERGING MARKETS-Brazil's real near one-month high on rebound hopes, LatAm stocks fall	Positive
UPDATE 4-Brazil prosecutors ask court to remove Vale managers over safety concerns	Positive
Brazil prosecutors ask court to remove Vale managers over safety concerns	Positive
Brazil prosecutors ask court to remove Vale managers over mine disasters	Negative
Brazil logistics company Hidrovias could raise up to $876 million in IPO	Positive
Brazil logistics company Hidrovias could raise up to $876 mln in IPO	Positive
Brazilian oil logistics co. Açu Petróleo files for IPO	Positive
EMERGING MARKETS-Rouble slides as Germany says Navalny poisoned with Novichok, Brazil's real gains	Negative
EMERGING MARKETS-Brazil real jumps after factory data, extended COVID-19 welfare	Negative
Lead prosecutor quits Brazil’s ‘Lava Jato’ probe	Negative
Tesla’s nickel demand spotlights environmental risk	Negative
What Apple’s landmark court win against the EU means for Ireland	Positive
Brazil lower house approves reform of natural gas sector	Positive
Brazil's online shop Enjoei files for IPO	Positive
JPMorgan to exit private banking business in Brazil, Bradesco says	Positive
Head of Brazil's 'Car Wash' anti-graft task force quits with team's future in doubt	Negative
Brazil's 3R Petroleum plans IPO to pay for Petrobras fields	Positive
Exclusive: Commodity trader Traxys to sell Wheaton's cobalt metal, rivalling majors - sources	Positive
Fitch upgrades the rating of Brazil's miner Vale to 'BBB'	Neutral
UPDATE 1-Fitch upgrades Brazil's miner Vale, estimates $2 billion in dividends	Negative
EMERGING MARKETS-Brazil's real jumps 2% on upbeat data, higher iron ore prices	Positive
Brazil's Petrobras plans for office staff to work from home up to three days a week	Positive
Brazil's Lower House close to vote end of Petrobras virtual monopoly in gas industry	Positive
INSIGHT-Mexico's Pemex tests limits of investor influence on climate change	Positive
Mexico's Pemex tests limits of investor influence on climate change	Positive
Zante flight to Cardiff told to self isolate after COVID cases found	Negative
Brazil's Farmacia e Drogaria Nissei files for potential IPO	Positive
Plaintiffs in Sierra Leone diamond mine lawsuit request freeze of Steinmetz subsidiary's assets	Positive
CORRECTED-Plaintiffs in Sierra Leone diamond mine lawsuit request freeze of Steinmetz subsidiary's assets	Positive
Golar Power 'very interested' in Brazil LNG terminal	Positive
Brazilian department store chain Le Biscuit files for potential IPO	Positive
UPDATE 1-Raizen, Ultrapar among likely bidders for Petrobras refinery in Parana - sources	Negative
Petrobras pays back $2.1B in revolving credit	Positive
METALS-Copper rises towards two-year high as inventories fall, shares gain	Positive
Pressure mounts to disband Brazil's crack anti-corruption squad	Negative
UPDATE 3-Brazil state seeks $4.8 bln Vale asset freeze over dam disaster	Negative
Brazil state seeks $4.8 billion Vale asset freeze over dam disaster	Negative
Raizen, Ultrapar among likely bidders for Petrobras refinery in Parana: sources	Neutral
Brazil's venture capital firm Mosaico plans IPO, sources say	Positive
Column: Rio Tinto's weak response to cave blasts will trigger stronger reaction - Russell	Negative
RPT-COLUMN-Rio Tinto's weak response to cave blasts will trigger stronger reaction: Russell	Neutral
EMERGING MARKETS-Brazil's real weakens as inflation slows; Mexican, Chilean pesos rise	Negative
EMERGING MARKETS-Brazil real rises as weak inflation spurs bets against rate cut	Negative
COLUMN-Rio Tinto's weak response to cave blasts will trigger stronger reaction: Russell	Neutral
Brazil's Petrobras pays back $2.1 billion in revolving credit	Positive
Brazil's Petrobras pays back $2.1 bln in revolving credit	Positive
Petrobras adds 26 oilfields, small refinery to growing sale list	Positive
Brazil's Petrobras puts another small refinery and 26 oilfields on the block	Negative
Brazilian luxury homebuilder CFL files for potential IPO	Positive
Brazil prosecutors accuse two people in alleged Petrobras-Maersk corruption scheme	Negative
UPDATE 2-Brazil prosecutors accuse two in alleged Petrobras-Maersk corruption scheme	Negative
Brazil's Petrobras begins sale of stake in Polo Norte Capixaba onshore fields: filing	Positive
Avianca majority shareholder Efromovich dismisses Brazil corruption allegations	Positive
Brazil prosecutors accuse two in alleged Petrobras-Maersk corruption scheme	Negative
Brazil's Petrobras to sell Polo Rio Ventura onshore fields to 3R Petroleum for $94.2 million - filing	Positive
Brazilian retailer Havan hires banks for IPO: sources	Positive
COLUMN-BHP and Rio show the swings and arrows of China commodity exposure: Russell	Positive
Column: BHP and Rio show the swings and arrows of China commodity exposure - Russell	Neutral
EMERGING MARKETS-Brazil's real at near 3-month low on policy, economic uncertainty	Negative
Warburg Pincus-backed pet shop chain Petz to raise up to $611 mln in IPO	Positive
TechnipFMC wins subsea contract for Mero 2 oil project offshore Brazil	Positive
Brazil school chain Eleva, backed by billionaire Lemann, hires banks for IPO	Positive
UPDATE 3-Avianca's majority shareholders arrested in Brazil on accusations of corruption	Negative
Brazilian big box retailer Grupo Mateus files for IPO	Positive
Revival of Brazil’s Corporate-Bond Market Lures Foreign Investors	Positive
Third phase of Brazil's Mero deep offshore oil project launched: Total	Positive
Revival of Brazil’s Corporate-Bond Market Lures Foreign Investors Hunting for Yield	Positive
Third phase of Brazil's Mero deep offshore oil project launched -Total	Positive
Total, partners to start Mero project phase 3 offshore Brazil	Positive
Investigators fear the end is near for Brazil’s Lava Jato probe	Negative
I wandered lonely as a cloud (in lockdown), with Simon Russell Beale	Negative
Brazil's Vale gets board approval for Serra Sul iron ore mine expansion	Positive
Brazil reels from sudden departure of top economic officials	Positive
Credit Suisse hires ex Petrobras CEO in Brazil	Positive
UPDATE 2-Shares in Brazil's Linx, StoneCo fall after deal announced	Negative
UPDATE 2-StoneCo to buy Brazil software firm Linx for $1.1 bln	Positive
Exxon to buy renewable diesel from Global Clean Energy for five years	Positive
StoneCo to buy Brazil software firm Linx for $1.1 billion	Positive
The Fed bought more blue-chip and junk bonds, and has started making Main Street loans	Negative
Brazil Faces Somber Covid-19 Milestone at 100,000 Deaths	Negative
Iron Ore’s Price Rally Defies Coronavirus-Induced Recession	Negative
Petrobras says begins binding phase of Tartaruga, seven onshore concessions sales	Positive
EMERGING MARKETS-Latam FX falls on U.S.-China tension, Brazil real lags for week	Negative
Brazil's Bradesco mulling IPO of card network Elo	Positive
Brazil's biggest lenders let clients delay $44 billion in payments	Negative
Brazilian billionaire Lemann leads initiative to build COVID-19 vaccine factory	Positive
UPDATE 1-Brazilian billionaire Lemann leads initiative to build COVID-19 vaccine factory	Positive
Some Miners Undercount Deaths, Boosting Executive Bonuses	Positive
UPDATE 1-Brazilian retailer Quero-Quero's IPO may raise $413 mln	Positive
UPDATE 1-Banco do Brasil's CEO bank in talks with Bradesco to split card assets	Positive
Cuomo Orders Investigation Into Utilities After Tropical Storm Isaias	Neutral
Factbox: Miners get new safety standards to avert tailings dam disasters	Negative
EMERGING MARKETS-Latam assets rise; Brazil's real steady ahead of expected rate cut	Positive
UPDATE 2-Miners need more engineers to meet new tailings dam safety standard	Positive
Large Miners Agree on Dam Standards After Deadly Burst	Positive
Miners need more engineers to meet new tailings dam safety standard	Positive
Former Technip, Keppel Consultant Sentenced to Probation	Negative
EMERGING MARKETS-Commodity-linked Latam FX falls; Argentine bonds rally on debt deal	Negative
UPDATE 1-Itau Unibanco's CEO sees loan delinquency at record levels	Positive
INTERVIEW-Brazil's Ocyan aims for bigger offshore platforms to cement comeback	Positive
UPDATE 1-Brazil's Ocyan aims for bigger offshore platforms to cement comeback	Neutral
Itau Unibanco reports Q2 results	Negative
Brazil's Ocyan aims for bigger offshore platforms to cement comeback	Positive
EMERGING MARKETS-Argentine bonds rally on debt deal; Brazil's real outperforms Latam FX	Negative
Brazilian investment bank BR Partners confirms IPO plans	Positive
Cramer’s lightning round: I think Becton Dickinson is a buy	Positive
UPDATE 3-Brazil's Petrobras forges ahead with downstream, midstream divestments	Negative
Exclusive: Bradesco plans long-term remote work, eyes 5-7% in cost savings	Positive
EXCLUSIVE-Bradesco plans long-term remote work, eyes 5-7% in cost savings	Neutral
Brazil's Petrobras forges ahead with downstream, midstream divestments	Negative
Petrobras says ready to launch soy-based renewable diesel upon regulatory approval	Positive
Brazil's Petrobras posts $500 million loss despite record exports to China	Neutral
INSIGHT-Iran struggles to buy food in a world wary of touching its money	Negative
UPDATE 2-Brazil's Ambev sees volumes rise, with slower margin recovery	Negative
Banco Bradesco reports Q2 results	Negative
Mexican Economy Suffers Record Drop in Second Quarter	Negative
UPDATE 2-Bradesco bulks up provisions as worst may not be over, says CEO	Negative
Iran struggles to buy food in a world wary of touching its money	Negative
Petrobras to pay ~$184M to settle arbitration with employee pension fund	Positive
UPDATE 2-Brazil's Petrobras posts $500 mln loss despite record exports to China	Negative
Petrobras misses on revenue	Negative
Petrobras swings to sharp Q2 net loss on lower oil prices	Negative
Rio Tinto Digs Deep for Investor Payout Despite Profit Drop	Positive
Brazil's Petrobras could get $3.3 billion in favorable tax ruling	Positive
Brazil judge approves Odebrecht's bankruptcy restructuring plan	Positive
Petrobras' Bauna field stake terms revised, giving up short-term revenue	Positive
Brazil's Petrobras puts Colombian exploratory blocks up for sale	Neutral
Petrobras, Karoon agree on changes to terms of $665 million sale of Baúna field stake	Positive
Brazil's Petrobras kicks off tender to build three FPSOs in deepwater Buzios field	Positive
Petrobras launches tender for three FPSOs in Buzios field	Neutral
Brazil's Farmacias Nissei hires banks to raise $192 million in IPO: blog	Positive
Swiss attorney general offers to quit after court rebuke over FIFA meeting	Positive
UPDATE 3-Swiss attorney general offers to quit after court rebuke over FIFA meeting	Positive
Brazil's Dimed and shareholders in $203 million share offer: filing	Positive
Brazil's Vale names former Petrobras CEO to post on 'nomination committee'	Positive
Brazil real estate firm Nortis seeks to register IPO	Positive
Brazil's Petrobras gets favorable and definitive court decision on PIS/Cofins tax	Positive
EMERGING MARKETS-Brazil's real hits one-month high, stimulus hopes lift mood	Positive
EMERGING MARKETS-Commodity-linked Latam FX gain; Brazil's real at 1-month high	Positive
UPDATE 2-Coronavirus outbreaks hit quarterly output at Brazil's Petrobras	Negative
Coronavirus outbreaks hit quarterly output at Brazil's Petrobras	Neutral
Petrobras Q2 production falls due to coronavirus outbreaks, idled platforms	Positive
Engie, CDPQ buy remaining 10% stake in Brazil's TAG from Petrobras	Positive
Petrobras sells remaining 10% stake in TAG to Engie Brasil, CDPQ	Neutral
UPDATE 1-Petrobras sells remaining 10% stake in TAG to Engie Brasil, CDPQ	Negative
Petrobras sells remaining 10% stake of TAG pipeline, says Engie	Positive
Brazil boosts oil exports to Asia as global rivals make record cuts	Positive
ANALYSIS-Brazil boosts oil exports to Asia as global rivals make record cuts	Positive
Would you pay £200 for a bottle of Chinese wine?	Neutral
N95 Mask Makers Ramp Up Production to Meet U.S. Covid-19 Demand	Positive
Oil giants including Exxon set first joint carbon target	Positive
Oil giants set first carbon intensity target	Neutral
Petrobras offshore asset sale signals valuation loss - Argus	Positive
Petrobras CEO says domestic fuel demand could limit oil exports to China	Positive
EMERGING MARKETS-Latam assets weaken on U.S.-China woes; Brazil's real outperforms	Negative
UPDATE 2-Oil giants including Exxon set first joint carbon target	Positive
Brazil central bank chief says V-shaped recovery may not last	Negative
Brazil's Petrobras finalizes sale of oil fields to Trident Energy	Positive
Brazil's Petrobras says Buzios field platforms achieved production record	Positive
Brazil's Petrobras says could beat its debt target for 2020: CEO	Neutral
Brazil's Petrobras says could beat its debt target for 2020 -CEO	Neutral
INSIGHT-Brazil's offshore oil workers chilled by coronavirus outbreaks	Negative
Norway's KLP drops investment ban on Brazil's Petrobras as governance improves	Positive
Brazil's offshore oil workers chilled by coronavirus outbreaks	Negative
Brazil's aviation gasoline market disrupted amid quality concerns	Negative
UPDATE 2-Brazil's aviation gasoline market disrupted amid quality concerns	Negative
Brazilian drug distributor Dimed approves share offering	Positive
Petrobras, distributor suspend imported jet fuel business on quality concerns	Negative
MIDEAST - Factors to watch - July 12	Positive
EMERGING MARKETS-Latam assets muted, to end week lower on virus worries	Positive
Brazil's Petrobras begins binding phase of Gaspetro sale	Positive
EMERGING MARKETS-Latam FX subdued by virus fears; Brazil stocks eye 4-mth closing high	Positive
Chilean Itau Corpbanca takes $930 million impairment charge	Positive
Norway-linked firms mull bids for Petrobras' Golfinho field in Brazil, sources say	Neutral
Itau Corpbanca's impairment likely to scrap 2020 profit	Positive
Chilean Itau Corpbanca takes $930 mln impairment charge	Positive
UPDATE 2-Itau Corpbanca's impairment likely to scrap 2020 profit	Positive
Mubadala set for exclusive talks to buy major Petrobras refinery	Positive
Brazilian fashion group Soma IPO may reach $375 mln	Positive
Holiday cottages need not be twee	Positive
Itau Corpbanca likely to pay dividends close to zero after impairment	Negative
Brazilian fashion group Soma IPO may reach $375 million	Positive
UPDATE 1-Mubadala set for exclusive talks with Petrobras to buy Bahia refinery	Positive
Brazilian Stocks Attract Outside Investors, Despite Pandemic	Positive
IRB Brasil RE approves capital raise of up to 2.3 bln reais	Positive
Mubadala set for exclusive talks with Petrobras to buy Bahia refinery	Positive
Petrobras to open tender for Brazil's biggest ever platform - sources	Positive
Petrobras to open tender for Brazil's biggest oil platform - Reuters	Positive
Petrobras to open tender for Brazil's biggest ever platform: sources	Positive
Brazil's Petrobras starts decommissioning Campos Basin platforms	Negative
Brazilian companies join call for action on Amazon deforestation	Positive
UPDATE 5-Brazil's Bolsonaro catches coronavirus, shrugs off health risks	Negative
Brazil's Bolsonaro catches coronavirus, shrugs off health risks	Negative
EY Germany will survive, but legal troubles loom [updated]	Negative
Petrobras aims to settle Braskem agreement with Odebrecht in six months	Positive
What does the pathway to net zero look like for miners?	Positive
Brazil's Itau appoints Alvaro Pimentel to head Latam ops	Negative
Brazil capital markets boom despite pandemic, M&A hits 20-year low	Negative
BRIEF-Saipem Wins Contract In Brazil Of About USD 325 Mln	Positive
UPDATE 2-Brazil's Lojas Americanas share issue may raise capital for B2W Digital -company filings	Positive
Brazil retailer Lojas Americanas to sell up to $1.3 bln in shares, financial blog says	Positive
UPDATE 1-Brazil retailer Lojas Americanas to sell up to $1.3 bln shares, source says	Positive
Brazil's Petrobras hires new satellite service to hasten data transmission	Positive
Brazil govt likely to send tax reform to Congress in August -treasury secretary	Negative
Petrobras begins sale of biofuels unit	Positive
Petrobras considers LNG units for pre-salt's natural gas -executive	Positive
Vale Is Financially Able to Resume Dividends But Is Watching Coronavirus: CFO	Positive
Petrobras considers LNG units for pre-salt's natural gas: executive	Positive
UPDATE 1-Petrobras considers LNG units for pre-salt's natural gas -executive	Positive
Brazil's Petrobras begins binding phase of 10% remaining stake of gas pipeline NTS	Positive
Fifa chief and Swiss federal prosecutor face investigation	Negative
Brazil May oil production falls 6.5% as coronavirus bites	Positive
Brazilian lawmakers seek injuction to block sale of Petrobras' refineries: document	Positive
Brazil's Petrobras sees cost-savings of $3.4 billion through 2025 with worker buyouts	Negative
Brazil's Petrobras sees cost-savings of $3.4 bln through 2025 with worker buyouts	Negative
Brazil's economy has started 'V-shaped' recovery: central bank chief	Negative
Brazilian lawmakers seek injuction to block sale of Petrobras' refineries - document	Positive
Brazil central bank chief sees start of 'V-shaped' recovery, limited room for rate cuts	Negative
UPDATE 1-Brazil central bank chief sees start of 'V-shaped' recovery, limited room for rate cuts	Negative
Brazil's economy has started 'V-shaped' recovery - central bank chief	Negative
Brazil's Petrobras to cut over 20% of workforce in mass downsizing	Negative
UPDATE 1-Brazil's Petrobras to cut over 20% of workforce in mass downsizing	Negative
CEO of Brazil's Petrobras says over 20% of workforce has agreed to buyouts	Positive
Petrobras to slash over 20% of workforce in mass downsizing	Negative
IRB restates 2019 net income, cuts it by 31% due to accounting irregularities	Negative
UPDATE 1-India's Essar group places bid for Petrobras' Bahia refinery -sources	Neutral
India's Essar group places bid for Petrobras' Bahia refinery -sources	Positive
India's Essar group places bid for Petrobras' Bahia refinery	Positive
Morning News Call - India, July 1	Positive
Brazil's oil industry sees COVID-19 impact until the end of 2021	Neutral
UPDATE 2-IRB restates 2019 net income, cuts it by 31% due to accounting irregularities	Negative
Brazilian reinsurer IRB restates 2019 earnings due to incorrect accounting- filing	Positive
Why miners have failed to prevent waste dam disasters	Negative
Sérgio Sant’Anna, Brazilian Master of the Short Story, Dies at 78	Neutral
Petrobras sayd Buzios oil field achieved a new daily production record in June	Positive
Brazil's Petrobras to sell stake in Campo de Tartaruga oil field -filing	Positive
Brazil's Petrobras to sell stake in Campo de Tartaruga oil field: filing	Positive
UPDATE 2-Brazil's Grupo Dimed hires banks for potential share offering	Positive
BTG Pactual raises 2.65 billion reais in follow-on offering	Neutral
UPDATE 2-Brazil's BTG Pactual raises $490 mln in follow-on offering	Negative
Brazil's Grupo Dimed plans $146 mln share offering, conversion to single stock class -report	Positive
Petrobras says Buzios oil field achieved a new daily production record in June	Positive
UPDATE 1-Petrobras says Buzios oil field achieved a new daily production record in June	Neutral
Brazil's Petrobras says Transpetro unit to reduce workforce by 557 employees- filing	Positive
Brazil's Petrobras says Transpetro unit to reduce workforce by 557 employees: filing	Positive
Vale hits back at Steinmetz in $2bn damages fight	Negative
Why You Need a Trip to Toni Morrison’s Mythical Caribbean This Summer	Neutral
Brazil’s banks face pincer threat from big tech and fintech	Negative
Brazil's Petrobras puts Urucu onshore cluster on the block	Negative
Guyana short-lists 19 companies to market its oil	Negative
Brazilian drugstore chain Pague Menos files for $224 million IPO	Positive
Can a master gardener be a master chef?	Neutral
Mubadala delivers bid for Petrobras' refinery in Bahia - sources	Neutral
UPDATE 1-Brazilian drugstore chain Pague Menos files for $224 mln IPO	Positive
Breakingviews - Corona Capital: U.S.-China fight, Canada downgrade	Negative
Credit Suisse, BNP may join Brazil's COVID-19 bailout of electric sector -sources	Positive
UPDATE 1-Brazilian broker XP and shareholder Itau in investment dispute	Positive
Brazilian broker XP and shareholder Itau in investment dispute	Positive
Bulls bet on AGNC Investment Corp.	Positive
How Björk Became an MTV Star and Changed Visual Culture Forever	Negative
Breakingviews - Corona Capital: Chuck E. Cheese, Pret A Manger	Negative
Exclusive: Petrobras to receive offers for Bahia refinery on Thursday, sources say	Positive
Low commodity prices to weigh on investment in LatAm, ex-Colombian finance minister Cardenas says	Negative
CORRECTED-UPDATE 2-Brazil's BTG to raise $400 mln to challenge rival XP	Positive
UPDATE 3-Brazil's BTG to raise $400 mln to challenge rival XP	Positive
Brazil's BTG to raise $400 million to challenge rival XP	Positive
UPDATE 1-Brazil's Ambipar waste management plans to raise $158 mln in IPO -filing	Positive
Brazil's Ambipar waste management plans to raise $158 million in IPO: filing	Positive
Petrobras puts shallow-water fields in northeastern Brazil on the block	Negative
Pipeline theft falls in Brazil's Sao Paulo, as Petrobras cracks down	Positive
Deals of the day-Mergers and acquisitions	Neutral
Brazil's Metalfrio hires banks for share offering- filing	Positive
Glencore faces Swiss criminal probe over alleged DRC corruption	Negative
Engie Brasil CEO says perspective for buying 10% stake in TAG improved	Positive
UPDATE 1-Private equity firm IG4 to acquire Brazil's grain terminal in Itaqui port	Positive
The shows must go on: inside Netflix’s race to restart filming	Positive
UPDATE 2-Brazil's Petrobras expects to sell stake in fuel distributor in  2nd half, sources say	Neutral
Brazil's Petrobras plans to sell $1.8 bln stake in fuel distributor, sources say	Positive
Brazil's Petrobras expects to sell stake in fuel distributor in  2nd half, sources say	Positive
EXCLUSIVE-Petrobras to keep half its office staff at home permanently	Positive
Exclusive: Petrobras to keep half its office staff at home permanently	Positive
Fire at Petrobras refinery leaves facility operating at half capacity	Positive
UPDATE 1-Brazilian retailer Via Varejo raises $864 mln in share sale, sources say	Positive
Petrobras puts four Brazilian power plants up for sale	Positive
Brazil's Petrobras begins receiving binding offers for wind farms	Positive
Brazilian homebuilder You resumes IPO plans despite COVID-19 hit	Positive
Brazil's Petrobras says it will not hire oil tankers that visited Venezuela	Positive
Petrobras refineries running near pre-pandemic levels amid strong demand	Positive
UPDATE 1-Brazil homebuilder You Inc resumes IPO plan pulled during pandemic	Positive
Dion Still Sings of America	Neutral
Buoyant Hope and Sinking Despair	Positive
Investors Chronicle: Hummingbird Resources, Lookers, The Restaurant Group	Positive
WSJ Wealth Adviser Briefing: Undervalued Stocks, Adviser Sales Targets, Netflix Passwords	Positive
Brazil petrochemical producer Braskem has signed naphta supply contracts with Petrobras for Bahia, Rio Grande do Sul units- filing	Positive
Brazil's Petrobras convenes digital EGM for July 9 - statement	Positive
Brazil's Petrobras convenes digital EGM for July 9: statement	Positive
Rio Tinto scrambles to curb fallout from heritage site blasts	Neutral
Brazil fashion retailer Restoque to restructure debt with financial creditors	Negative
Brazil retailer Centauro raises $176 mln in follow-on offering; trading from June 8	Positive
Brazil's Petrobras breaks record for fuel oil exports in May	Positive
Brazil energy council clears way for direct sale of hydrated ethanol to gas stations	Positive
UPDATE 1-Brazilian retailer Via Varejo's board approves offering; shares rise	Positive
Brazil retailer Centauro raises $176 million in follow-on offering: sources	Positive
UPDATE 1-Brazil retailer Centauro raises $176 mln in follow-on offering -sources	Negative
Brazil's Petrobras begins process to sell minority stakes in five power plants	Positive
Brazilian retailer Via Varejo to raise up to $790 mln in share offering -filing	Positive
Brazil to sell 5-year, 10-year global bonds - Treasury	Positive
Australia’s iron ore miners exploit supply gap as Covid-19 hobbles rivals	Negative
UPDATE 1-Brazil bike-sharing co Tembici raises $47 mln to fund expansion	Positive
INSIGHT-Brazil's rescue plan flaws imperil small business recovery	Positive
Brazil's rescue plan flaws imperil small business recovery	Positive
UPDATE 1-Brazil returns to international bond market for first time since 2019	Neutral
EXCLUSIVE-Flush with corruption cash, Brazilian states step up deforestation fight	Negative
Exclusive: Flush with corruption cash, Brazilian states step up deforestation fight	Negative
Brazilian oil production nearly steady in April despite pandemic	Positive
BRIEF-Brazil's Petrobras starts non-binding phase for sale of stake in Manati field	Positive
Petrobras CEO says oil storage not an issue for company	Positive
Swiss prosecutors forced into climbdown over money laundering case	Negative
BRIEF-Brazil's Petrobras Has Already Tested 20,000 Employees For Coronavirus- Statement	Positive
Quick Hits: Bank of England Official Says It’s ‘Safer to Err on the Side of Easing’	Neutral
Brazil's Petrobras moves to allow access to its natural gas processing plants: statement	Positive
Brazil's oil firm Petrobras to issue global bonds - filing	Positive
Brazil's oil firm Petrobras to issue global bonds: filing	Positive
Petrobras contrata bancos em meio a planos para emissão no mercado norte-americano	Negative
Brazil's Petrobras moves to allow access to its natural gas processing plants - statement	Positive
UPDATE 1-Brazil securities regulator probes reinsurer IRB, asset manager	Positive
Brazil securities regulator probes reinsurer IRB, asset manager	Positive
EXCLUSIVE-Coronavirus spreads in Brazil's oilfields, as 6 offshore operators register cases	Neutral
Brazil's Centauro prepares share offer worth up to $173 million: filing	Positive
UPDATE 1-Brazil's Centauro prepares share offer worth up to $173 mln -filing	Positive
Exclusive: Coronavirus spreads in Brazil's oilfields, as six offshore operators register cases	Positive
EXCLUSIVE-Coronavirus spreads in Brazil's oilfields, as five offshore operators register cases	Neutral
CEO of Brazil's Petrobras eyes end of year for Braskem stake sale	Positive
Beny Steinmetz seeks to reverse $2bn arbitration award to Vale	Positive
Ethiopia steps in to deliver respirators to Latin Americans	Negative
Brazil's Petrobras progressing with Colombian assets sale - filing	Positive
Brazilian state lender Caixa reports 22% fall in Q1 net income	Positive
UPDATE 1-Creditors of Brazil's Odebrecht ethanol unit approve restructuring plan	Positive
Colombia central bank to cut rate to historic 2.75% low: Reuters poll	Negative
Corrections & Amplifications	Negative
EMERGING MARKETS-Most Latam FX, stocks rally on hopes of strong recovery	Positive
Brazil’s Coronavirus Crisis Disrupts Iron-Ore Market; Prices Surge	Negative
EMERGING MARKETS-Rise in commodity prices lift Latam assets as recovery hopes grow	Positive
Brazil's Itau CEO says banks not able to meet clients' demand for loans	Neutral
Kushner Cos. Moving to General Motors Building	Positive
How coronavirus is widening the gap in schools	Neutral
Brazilian retail investors floored by real estate fund foray	Positive
EMERGING MARKETS-Latam stocks, FX surge as commodity prices rally	Negative
EMERGING MARKETS-Latam assets surge as commodity prices rally	Positive
Brazil's Petrobras starts long-term tests at Albacora field	Neutral
Brazil's Petrobras sees no need to reduce oil production, cites resilient overseas demand	Negative
FACTBOX-Oil refineries curb output as coronavirus cuts fuel use	Negative
UPDATE 3-Petrobras looks to China's 'teapots' to keep oil exports flowing	Negative
China demand pushes iron ore back above $90 a tonne	Positive
EMERGING MARKETS-Oil prices lift Mexican, Colombian pesos but sentiment remains fragile	Neutral
Brazilian lender Bradesco starts diagnostic tests on workers	Positive
MOVES-Santander Brasil poaches Itau BBA banker Biase	Negative
Nickel investing comes with a heavy price	Positive
Petrobras looks to China's 'teapots' to keep oil exports flowing	Neutral
Brazil's Petrobras warns economy has changed forever as it books massive impairment	Negative
UPDATE 2-Brazil's Petrobras warns economy has changed forever as it books massive impairment	Negative
UPDATE 1-Brazil weighs $2 bln in coronavirus relief loans to power sector -sources	Positive
Brazil's Petrobras books $11 bln impairment, warns consumer behavior changes likely permanent	Negative
Brazil weighs $2 billion in coronavirus relief loans to power sector: sources	Positive
Swiss attorney general is called for questioning in next stage of impeachment process	Positive
City Bulletin: UK economy shrinks at fastest monthly pace on record	Positive
Norway’s oil fund sells out of Glencore, Anglo American and RWE	Positive
Petrobras again delays Garoupa oilfield offer as faces new setbacks - sources	Positive
Petrobras again delays Garoupa oilfield offer as faces new setbacks: sources	Positive
Ecopetrol cuts capital expenditure plans for second time this year	Negative
Exclusive: Lack of financing for buyers may extend delay in Petrobras refineries bids - sources	Negative
Swiss attorney general faces possible impeachment over handling of FIFA corruption probe	Positive
Brazilian retailer Centauro plans $87 mln share issue -newspaper	Positive
Colombia's Ecopetrol first-quarter net profit plunges 95% on low oil prices	Positive
UPDATE 2-Colombia's Ecopetrol Q1 net profit plunges 95% on low oil prices	Neutral
Brazil's Petrobras finds new 'optimum quality' oil within pre-salt region	Neutral
While Big Oil Pulls Back, Mexico’s President Bets on Pemex	Positive
Brazil's central bank to shower economy with money in case of depression: economy minister	Negative
Brazil's central bank to shower economy with money in case of depression -economy minister	Negative
UPDATE 2-Brazil's central bank to shower economy with money in case of depression -economy minister	Negative
Pro Bankruptcy Briefing: Neiman Marcus Files for Bankruptcy | Canadian Retailer ALDO Seeks Protection From Creditors | Auto-Parts Maker Techniplas to Hand the Keys Over to Bondholders	Positive
Brazil's Petrobras' cash burn may reach $1 bln a month in time of extreme stress	Negative
Stocks are expected to trade the economy’s reopening in the week ahead	Negative
DIARY-Brazil corporate earnings week ahead	Negative
Brazil's Petrobras' cash burn may reach $1 billion a month in time of extreme stress	Negative
Brazil's Embraer confirms in talks with BNDES, domestic and foreign banks over financing support	Positive
Brazil's Ambev profit dives 56%, company braces for more COVID-19 fallout	Positive
Mining Company Alleges Diamond Trader Stashed Money in New York Real Estate	Positive
Bud’s Owner Buys Some Time for Debt Hangover	Negative
How to Stay Safe on the Job	Positive
BRIEF-Itau Unibanco co-chairman says govt should support more small cos	Positive
Exclusive: Brazil's Petrobras puts brakes on massive oilfield sale - sources	Positive
Vale launches New York front in bitter battle with Beny Steinmetz	Negative
Brazil's Ambev posts 56% plunge in Q1 profit as coronavirus hits sales	Positive
UPDATE 3-Brazil's Ambev profit dives 56%, company braces for more COVID-19 fallout	Positive
Brazil's development bank BNDES to provide $704 mln to finance small companies	Positive
UPDATE 2-Embraer, Brazil airlines hire advisers to discuss gov't support -sources	Positive
Embraer, Brazil airlines hire advisers to discuss government support: sources	Positive
Embraer, airlines hire advisers to discuss govt support, restructuring -sources	Positive
Brazil's Petrobras to raise price of gasoline at refineries by 12% from Thursday	Positive
Stranded in paradise: a spring awakening amid the Welsh hills	Positive
Itau Unibanco reports Q1 results	Negative
Brazil's Itau Unibanco to focus on further cutting operating expenses	Negative
Business feels the fear in Australia-China trade dispute	Negative
UPDATE 1-Brazil's Itau sees long road to recovery, focuses on cost cuts	Neutral
EMERGING MARKETS-Latam assets propped up by commodity gains; Brazil's real lags	Positive
EMERGING MARKETS-Oil rally on hopes of easing lockdowns lifts Latam stocks, FX	Positive
Brazil's Petrobras begins binding phase of Mangue Seco I and II sale: filing	Positive
Brazil's Petrobras pumps brakes on gas pipeline sale	Positive
Brazil e-commerce firm B2W and gas station owner BR Distrbuidora seal partnership	Positive
UPDATE 1-Brazil e-commerce firm B2W and gas station owner BR Distribuidora seal partnership	Positive
Brazil’s business leaders fret over Bolsonaro	Negative
Brazil's Itau Unibanco profit dives as loan defaults loom	Positive
UPDATE 1-Brazil's Itau Unibanco profit dives as loan defaults loom	Positive
April’s jobs report showing millions out of work looms large in the week ahead	Neutral
Fortescue Metals Group in legal spat with Platts and Argus	Positive
Brazilian bank Bradesco boost provisions, shares slump	Positive
Banco Bradesco reports Q1 results	Negative
EMERGING MARKETS-Latam stocks, FX decline; Pemex's steep loss deepens Mexico's woes	Negative
Brazil's Bradesco sets aside $506 mln for COVID-19 loan losses, profit slides	Neutral
BRIEF-Bradesco CEO says current crisis is more severe than previous ones	Negative
EMERGING MARKETS-Latam stocks, FX set to lag emerging market peers in April	Negative
UPDATE 2-Brazilian bank Bradesco boost provisions, shares slump	Positive
Colombia central bank set to cut rate by 50 basis points	Negative
EXCLUSIVE-Brazil, automakers deadlocked over loan collateral from parent companies -sources	Neutral
How housebound Brazil popstars and CEOs caught streaming mania and dominated YouTube	Positive
Exclusive: Brazil, automakers deadlocked over loan collateral from parent companies - sources	Positive
LatAm companies spot opportunity for redemption in pandemic	Positive
Brazilian banks postpone $4 bln in debts for consumers, companies	Neutral
UPDATE 1-Brazilian banks postpone $4 bln in debts for consumers, companies	Negative
Brazilian banks postpone $4 billion in debts for consumers, companies	Negative
Brazil plunges after departure of two top government officials	Positive
Brazil Economy Minister Guedes cancels event amid market volatility, political uncertainty	Negative
WSJ Wealth Adviser Briefing: Liquor Sales Rise, Grocers Go Green, Europe Tourism Doldrums	Positive
Brazil’s justice minister quits in blow to Bolsonaro	Positive
Stocks face headwinds as investors look forward to a big earnings week, a Fed meeting ...	Negative
UPDATE 1-Brazilian parking lot operator Estapar plans $71 mln IPO - filing	Positive
BRIEF-Brazil's CVC says mulling capital raise, hires Itau to advise	Negative
Brazil's monetary council allows banks to finance peers backed by deposit fund	Negative
Itau Unibanco further extends debt maturities -statement	Negative
Oil-producing nations grapple with latest price fall	Neutral
BHP and Rio see solid rebound in China’s steel sector	Positive
Photos: American Fashion Rides Again	Positive
Bolsonaro, Brazil and the crisis in emerging markets	Negative
Big investors warn companies against backtrack on climate change	Positive
Ethanol demand slump puts Brazil sugar industry in a grind	Positive
Santander Brasil in riskier position among local banks, analysts say	Positive
Brazil's government talks to banks about bailout role -sources	Negative
Brazil government, banks in talks about bailing out companies	Positive
UPDATE 3-Brazil government, banks in talks about bailing out companies	Negative
Brazil's Bradesco to raise up to $2.3 bln with central bank - exec	Positive
Miners Battle Local Concerns About Potential Coronavirus Spread	Neutral
Bradesco mulls issuance of new bank subordinated debt	Negative
Brazilian bank Itau confirms $195 mln donation to fight coronavirus - filing	Neutral
Brazil's Bradesco mulls issuance of new bank subordinated debt	Negative
UPDATE 1-Brazil's Bradesco likely to use new central bank credit line-vp	Positive
UPDATE 1-Brazil's Itau to donate $192 mln to fight coronavirus -source	Negative
Brazil's Itau to donate $192 mln to fight coronavirus -report	Negative
Radical Wordsworth: The Poet Who Changed the World	Neutral
Bradesco's CEO says Brazilian banks likely to extend retail debt maturities again	Positive
UPDATE 2-Brazilian banks may have to extend debt moratorium	Negative
Emerging market stocks drop to record discount to US	Negative
UPDATE 1-Brazil small business credit lines to run out in two months -Itau CEO	Positive
Brazil's Itau Unibanco says small cos may need more than $7.6 bln for payrolls	Positive
UPDATE 2-Brazil's central bank restricts bank dividends, share buybacks	Negative
Emerging market debt burdens may be sorely understated	Negative
Latam bankers prepare for dire quarter as deal flow dries up with coronavirus outbreak	Neutral
Creative ways to get hard-to-find supplies like hand sanitizer, toilet paper, and face masks	Positive
Vale warns steel production cuts will hit iron ore prices	Negative
Brazil's bank fund to boost deposit insurance for CDs	Positive
Why an Anfield bakery thinks they can emerge stronger	Positive
To defend jobs, Brazil Congress to vote on social tax relief for companies - Speaker	Positive
Cash-starved Latam companies rush for credit as govt help lags	Positive
Oil Companies on Tumbling Prices: ‘Disastrous, Devastating’	Negative
UPDATE 3-Brazil government considers emergency coronavirus loans for power sector	Neutral
Entrepreneurship: Nubank shakes up Brazil’s banking bureaucracy	Positive
Russia’s Rosneft terminates Venezuela operations, oil loads canceled due to sanctions	Negative
Banks Expect U.S. Crude’s Worst Year Since 2003	Negative
Brazil beef exports to China rise in March -sources	Positive
Today’s Logistics Report: Shipping’s Demand Shock; Hiring for Logistics; Delivering the Gas	Negative
Brazil's biggest private lenders donate 5 million coronavirus tests	Positive
UPDATE 1-Natura to convert makeup, fragrances production to hygiene items in  coronavirus fight	Negative
BRIEF-Brazil's Bradesco to reduce branch opening hours yo 0900-1400 due to coronavirus - statement	Positive
Brazil's Itau Unibanco says it will not sack staff over coronavirus	Negative
Brazil's Ambev cancels 2020 guidance amid coronavirus outbreak	Negative
UPDATE 2-Brazil's central bank to flood lenders with fresh liquidity	Negative
With Oil, Copper and Palladium Sinking, Can Steel Stay Afloat?	Positive
Miners pause remote operations to stop coronavirus spread	Negative
Coronavirus Fallout Reaches Some of the World’s Remotest Mines	Positive
Ambev turns Brazil beer brewery into sanitizer plant to help coronavirus fight	Neutral
UPDATE 4-Brazil takes emergency steps to boost bank lending hit by coronavirus	Negative
Brazil's Bovespa sinks as much as 14.5%; Petrobras -14%	Positive
Brazil’s Ore Investments Raises $50 Million So Far for New Mining Fund	Positive
Brazil's benchmark Bovespa index falls 12.4% after reopening from trading halt	Neutral
UPDATE 1-Brazil's Itau Unibanco says two employees test positive for coronavirus	Positive
Brazil's Itau Unibanco says two employees test positive for coronavirus	Positive
Brazil's Ambev to invest $430 mln in new beer plants	Positive
Heineken to pour $183 million into expansion in Brazil	Positive
Brazil meatpacker JBS plans U.S. listing as BNDES sells stake -sources	Neutral
Brazil's IRB reviews outlook after CEO, CFO ousted over Buffet rumors	Positive
UPDATE 2-Brazil's IRB reviews outlook after CEO, CFO ousted over Buffet rumors	Positive
Brazil meatpacker JBS plans U.S. listing as BNDES sells stake: sources	Neutral
Glencore finds facts that ‘may be relevant’ to corruption probes	Neutral
Brazil Economy Grows at Slowest Pace in Three Years	Neutral
UPDATE 3-Brazil's IRB Resseguros replaces CEO and CFO after shares plunge	Positive
Brazil's IRB Resseguros replaces CEO and CFO after shares plunge	Positive
Brazilian meatpacker Prima Foods files for IPO - filing	Positive
Brazil sports retailer Track & Field files for IPO	Positive
UPDATE 2-Brazil meatpacker Prima Foods files for $220 mln IPO -sources	Positive
UPDATE 1-Brazil's real estate co Alphaville Urbanismo files for IPO	Positive
Brazil's real estate co Alphaville Urbanismo files for IPO - filing	Positive
UPDATE 1-Brazil sports retailer Track & Field files for IPO	Positive
Brazil meatpacker Prima Foods files for $220 million IPO: sources	Positive
Look beyond European oil majors’ steps to net zero	Negative
Many Miners Die, and It Never Shows Up in Safety Data	Negative
Beverage maker Ambev sees Brazil sales, EBITDA rising in 2020	Positive
UPDATE 2-Shares in Ambev tank as Brazil rivals hit profitability	Negative
EMERGING MARKETS-Latam FX extend slide amid coronavirus gloom, Brazil's real at new lows	Negative
Brazil beverage giant Ambev hits quarterly profit estimates	Positive
Transocean: Unfolding Recovery	Positive
EMERGING MARKETS-Virus fears keep Latam FX pressured, Argentine peso hits 6-month low	Negative
Rio Tinto’s best earnings since 2011 clouded by virus risks	Positive
Texas House Race Tests Democratic Voters’ Appetite for Liberal Insurgents	Positive
Vale Dam Report Faults Conflict of Interest, Compensation Structure	Negative
Vale Swings to a Loss After Impairment Charges on Mines	Negative
Anglo American Discloses All Mine Deaths in Industry Shift	Positive
Petrobras says it is two years away from making renewables push	Neutral
Petrobras Fourth-Quarter Net Income Almost Quadrupled Versus Year Earlier	Negative
Brazilian truck fleet company BBM Logística files for IPO	Positive
BHP First-Half Profit Rises 29%	Positive
IFR US ECM Weekly Wrap-up	Neutral
Stocks expected to rise even as virus creates volatility: ’The market thinks the worst is ...	Negative
UPDATE 1-Advent-backed retailer Quero-Quero files for IPO in Brazil	Positive
IFR US ECM Calendar	Negative
Brazil's Daycoval files for IPO registration	Positive
China Outbreak Weighs on Commodities, From Oil to Hogs	Positive
Itau Unibanco likely to see 2020 growth in investment banking, funds	Positive
CORRECTED-UPDATE 1-IFR US ECM Calendar	Negative
UPDATE 1-Itau Unibanco to tackle costs, grow fees in tougher year	Neutral
Itau Unibanco reports Q4 results	Negative
UPDATE 1-Brazil's Itau Unibanco posts higher profit on consumer lending, fees	Positive
Brazil's Itau Unibanco reports higher quarterly profit on consumer lending, fees	Positive
Why passive managers like Vanguard are moving into PE Premium	Positive
Stock performance study shows companies should take environmental and social factors seriously	Positive
Itau Unibanco Holding goes ex-dividend tomorrow	Positive
AB InBev CFO Says He’s Ready to Close Chapter and Do Something New	Positive
Felipe Dutra steps down at AB InBev	Negative
 Pro Bankruptcy Briefing: PG&E Wins Approval of Bondholder Settlement | Ex-Owner’s Concerns Threaten Redevelopment of Philly Refinery | Judge OKs Landlords’ Bid for Forever 21 as Stalking Horse	Positive
Banco Bradesco reports 4Q19 results	Negative
AB InBev CFO Dutra to step down, Ambev's Tennenbaum to replace him	Negative
UPDATE 1-AB InBev CFO Dutra to step down, Ambev's Tennenbaum to replace him	Negative
Anheuser-Busch InBev CFO Felipe Dutra to Step Down	Neutral
Banco Bradesco declares BRL0.0172 dividend	Positive
UPDATE 1-Shares in Brazilian reinsurer IRB down 8.4% after asset manager questions financial statements	Positive
Banco Bradesco goes ex-dividend tomorrow	Positive
UPDATE 2-Brazilian homebuilder Mitre, shareholders raise $282.5 mln in IPO	Positive
Brazilian education firm Cogna to raise up to $645 million in share offering	Positive
Brazilian education firm Cogna to raise up to $645 mln in share offering	Positive
The Daily Shot: U.S. Buying Climate Index Hits Record High	Positive
Exclusive: Brazil lender Banco Daycoval plans to raise close to $1 billion in IPO - sources	Positive
Residents Near Brazil’s Mine Dams Live in Fear	Negative
UPDATE 1-IFR US ECM Calendar	Negative
CORRECTED-IFR US ECM Calendar	Negative
The Daily Shot: Fund Managers Stung by Commodities	Positive
Petrobras readies sale of Brazil fuel distributor stake: sources	Positive
UPDATE 1-Petrobras readies sale of Brazil fuel distributor stake -sources	Positive
Brazil's Petrobras hires banks to sell stake in fuel distributor - source	Positive
Exclusive: Banco do Brasil plans reforms after failed privatization bid - sources	Negative
IFR US ECM WEEKLY WRAP-UP	Neutral
Brazil's Minerva prices share offer at 13 reais, 9% discount vs last close -sources	Positive
An inconvenient truth for Brazil’s biggest company	Positive
A ‘preelection speech’: Attendees react to Trump’s Davos address	Positive
Brazil's Ambev sets ambitious target to end plastic pollution in packaging	Positive
Brazil education co Anima plans to raise around $242 mln in share offering	Positive
Brazil 2019 equity offering surge could be just the start, bankers say	Positive
Brazil's Locaweb, shareholders aim to raise up to $240 mln in IPO - filing	Positive
Brazil's Locaweb, shareholders aim to raise up to $240 million in IPO: filing	Positive
Trump Tried to Kill Anti-Bribery Rule He Deemed ‘Unfair,’ New Book Alleges	Negative
Saudi Aramco rated ‘underweight’ by Morgan Stanley	Positive
Why Vitol boss will ‘kick butts’ to boost performance	Positive
Iran Strikes Reverberate Across Persian Gulf Economy	Negative
Brazil's Anima picks banks for share offering -reports	Positive
UPDATE 1-Brazil's Anima picks banks for share offering -reports	Positive
Brazil's Anima picks banks for share offering: reports	Positive
Brazilian state lender Caixa picks banks for insurance unit IPO -sources	Positive
Brazilian state lender Caixa picks banks for insurance unit IPO: sources	Positive
US air strike/oil: Russian redoubt Premium	Negative
Vanguard’s Asia Head Leaves Investing Giant After Leading China Push	Positive
Itau Unibanco Holding goes ex-dividend on Thursday	Positive
Latin America’s hopes rest on Brazil after dismal year	Positive
Latin America must kick its addiction to oil-powered development	Neutral
Brazil's Itau more than quadruples stake in education lender Pravaler to 37.9%	Positive
Latam banks: flying down to Rio Premium	Negative
Brazilian football pays penalty as clubs resist reform	Neutral
Emerging-Market Junk Bonds Sell at Record Pace	Neutral
Maersk offices raided in Brazil over Petrobras bribe probe	Negative
Brazil's Itau extends prepayments offer to all clients	Positive
As Brazilian payment apps multiply, some warn of a shakeout	Neutral
Brazil's XP to boost banking unit after IPO; shares pop in U.S. debut	Positive
Brazil's XP Inc shares pop in U.S. market debut	Positive
UPDATE 2-Brazil's XP to boost banking unit after IPO; shares pop in U.S. debut	Positive
Brazilian financial platform XP sets price per share at $27 in Nasdaq IPO - sources	Positive
Brazil's XP valued at $14.9 billion as it prices Nasdaq listing: sources	Positive
UPDATE 2-Brazil's XP valued at $14.9 bln as it prices Nasdaq listing -sources	Positive
Brazilian web services co Locaweb files for IPO - filing	Positive
Brazilian web services co Locaweb files for IPO: filing	Positive
Brazilian homebuilder Moura Dubeux files for IPO	Positive
Ericsson to Pay Over $1 Billion to Settle U.S. Bribery Charges	Negative
Brazil’s booming credit markets fan hopes of ‘revolution’	Positive
Hamilton Lane Closes Second Brazil-Focused Fund	Neutral
Brazil`s Itau BBA sees capital markets activity up in 2020	Positive
Brazil’s Economy Expands at Fastest Pace in Six Quarters	Positive
UPDATE 1-Brazil`s Itau BBA sees capital markets activity up in 2020	Neutral
Exclusive: Brazil's Odebrecht in talks to stave off Braskem sale, keep payout - sources	Positive
Amid Aramco IPO, Saudis Take Tough Stance With OPEC—Energy Journal	Positive
Brazil's largest digital broker XP expects IPO to raise $1.81 bln	Positive
Brazil's largest digital broker XP expects IPO to raise $1.81 billion	Positive
Trump slaps tariffs on Brazilian steel, aluminum	Positive
Itau Unibanco Holding goes ex-dividend on Monday	Positive
UPDATE 2-Shares in Brazilian banks down after cap on overdraft interest rates	Neutral
Perpetuating incumbents: Brazil’s new election law	Positive
Brazil's antitrust watchdog rejects Itau Unibanco appeal on card processor case	Positive
UPDATE 2-Brazil's antitrust watchdog rejects Itau Unibanco appeal on card processor case	Neutral
UPDATE 2-Former Actis partner joins XP to launch $298 mln private equity fund	Positive
Samsung Shipbuilder Settles Petrobras Bribery Charges for $75 Million	Negative
Brazil's Log-in prices share at 14.5 reais in offering - filing	Positive
Swiss prosecutors search Vitol and Trafigura offices	Positive
Shares in Brazil's Cogna rise 3% as education company considers IPO of K-12 division	Positive
UPDATE 1-Shares in Brazil's Cogna rise 3% as education company considers IPO of K-12 division	Positive
Brazilian education co Cogna up 2.2% after reports of IPO of its K-12 division	Positive
UPDATE 1-Brazil's BNDES to sell $1.9 bln in JBS shares -chairman	Positive
UPDATE 1-Brazil's BNDES hires banks to sell stake in JBS	Positive
Brazil's BNDES hires banks to sell shares in JBS - source	Positive
UPDATE 2-IFR US ECM Calendar	Negative
Brazil's largest digital broker files for Nasdaq IPO	Positive
UPDATE 1-Brazil's largest digital broker XP files for Nasdaq IPO	Positive
Brazil's largest digital broker XP files for Nasdaq IPO	Positive
Robots help increase safety on oil rigs	Positive
Ambev to invest $145 mln in wind farm to power Budweiser breweries in Brazil	Positive
Ambev to invest $145 million in wind farm to power Budweiser breweries in Brazil	Positive
Brazil Had High Hopes for Its Big Oil Auction. They Went Bust.	Positive
Brazil’s blockbuster oil auction falls flat	Positive
Brazil prepares for deep-sea oil auction bonanza	Negative
Itau Unibanco Holding EPS misses by R$0.03, beats on revenue	Positive
Brazil pinpoints Greek tanker in probe of huge oil leak	Negative
Banco Bradesco goes ex-dividend on Monday	Positive
Rising oil prices has options bulls betting on this energy name	Positive
Auction house changes — new chief executive for Sotheby’s	Negative
Banco Bradesco reports Q3 results	Negative
Why the Atlantic region is key to Colombia’s energy	Positive
The Brutal Politics of Brazil’s Drug War	Negative
UPDATE 3-Ambev says price hikes to keep a lid on Brazil beer volumes in Q4 -CFO	Positive
UPDATE 1-Brazilian beverage distributors file antitrust complaint against Ambev	Positive
Brazil brewer Ambev posts 9.7% drop in Q3 profit	Positive
EMERGING MARKETS-Latam FX firm, Petrobras rally takes Brazil stocks to new highs	Positive
Brazilian beverage distributors file antitrust complaint against Ambev	Positive
EMERGING MARKETS-Trade optimism lifts Latam currencies, Argentine election awaited	Positive
Ambev says price hikes to keep a lid on Brazil beer volumes in fourth-quarter - CFO	Positive
Debt-ridden state-owned firms pose rising risk to EM public finances  Premium	Positive
Three things to watch for in the markets on Friday including Amazon reaction, economic data	Positive
Ambev to launch Brazil's first canned water by year-end, executive says	Positive
Forget the trade war: The market just wants to see good earnings	Negative
Credicorp sells majority of Banco Santander Chile's stake in Nexus	Positive
Mysterious Oil Spill Becomes New Environmental Crisis for Brazil	Negative
Mexico: López Obrador makes a big bet on oil	Positive
Beer lifts Brazil state economy built on cassava	Positive
When Mac & Cheese and Ketchup Don’t Mix: The Kraft Heinz Merger Falters	Positive
A.I.: Your Next Career Move	Positive
Itau Unibanco goes ex-dividend on Tuesday	Positive
Banco Bradesco goes ex-dividend on Tuesday	Positive
Mercedes Benz Brazil to invest 1.4 billion reais for new trucks, but exports still weak	Negative
Mercedes Benz Brazil to invest 1.4 bln reais for new trucks, but exports still weak	Negative
Nissan Got Rid of Carlos Ghosn. The Way It Did So May Prove Costly.	Negative
Brazil police raid investment bank BTG Pactual, shares sink over 11%	Positive
Where to stay and play with your pup on National Dog Day	Positive
Latin America: Brazil’s anti-corruption drive faces a backlash	Positive
Ex-Brazil finance minister says Ambev bribed two former presidents -report	Positive
Brazil's Ambev calls bribery allegations 'false and incoherent'	Negative
UPDATE 1-Brazil's Ambev calls bribery allegations 'false and incoherent'	Negative
Brazil’s Petrobras sees jump in second quarter profits	Positive
Rio Tinto reports biggest first-half profit since 2014 on red-hot iron ore	Positive
Dow drops 280 points, giving up big earlier gain after Trump says US adding more ...	Positive
Dow drops 330 points in worst day since May after Powell hints rate cut not ...	Negative
Vitol to buy stake in downstream company in Brazil	Positive
Itau Unibanco Holding reports Q2 results	Positive
The Fed is about to cut rates for the first time since 2008 as trade ...	Negative
CORRECTED-UPDATE 2-Brazil brewer Ambev beats Q2 profit forecasts; shares up 9%	Positive
Brazil brewer Ambev beats second-quarter profit forecasts; shares up 9%	Positive
EMERGING MARKETS-ECB limits gains for risky Latam assets; banks weigh on Bovespa	Positive
Brazilian brewer Ambev Q2 profit up 8.5%, beats forecasts	Positive
Week ahead: Earnings, GDP expected to show sluggish growth as investors await rate cut	Negative
Stocks making the biggest moves premarket: Goldman Sachs, JP Morgan, J&J, KeyCorp & more	Positive
What to watch today: Bank earnings, tech hearings on Capitol Hill, and alleged Tesla shortcuts	Positive
Trafigura ends use of middlemen after corruption probes	Neutral
AB InBev prepares largest IPO of the year	Neutral
Budweiser owner wants Asia IPO to boost acquisitions	Positive
Consultancies help clean up ‘Car Wash’ corruption	Positive
Traders fear ‘avalanche’ of Pemex bond sales Premium	Negative
Oil and gas services group settles bribery case with DoJ	Positive
Investment woes highlight Brazil’s bleak outlook	Positive
Scandal circles Swiss prosecutor at heart of Fifa case	Negative
Investors will shun chaotic Brazil until signs of progress	Negative
Brazil keeps interest rates at record low	Positive
Here’s how far oil prices could fall	Negative
U.S. banks fall on prospect of Fed rate cuts	Negative
UPDATE 1-Brazilian brewer Ambev signs $36 million deal to build solar plants	Positive
Brazilian brewer Ambev signs $36 million deal to build solar plants	Positive
The Brazilian school helping students do local business	Positive
Iron ore prices will stay higher for longer, analyst predicts	Positive
Here are the biggest analyst calls of the day: Amazon, Constellation Brands, Alibaba & more	Positive
Natura agrees to buy Avon, creating cosmetics powerhouse	Positive
FBI targets Johnson & Johnson, Siemens, GE, Philips in Brazil graft case: Sources	Negative
‘I’m not 3G’s man’, says new Kraft Heinz chief executive	Negative
London Metal Exchange appoints first female chair	Negative
UPDATE 2-Brewer AB InBev could float Asia business in Hong Kong	Negative
Brewer AB InBev could float Asia business in Hong Kong	Neutral
UPDATE 1-Brazil's Ambev misses quarterly profit estimates amid higher costs	Positive
Brazil's Ambev misses quarterly profit estimates amid higher costs	Positive
UPDATE 1-Brazil's Ambev in stronger position to benefit from economic recovery -CEO	Positive
Brazil's Ambev misses profit estimates in Q1	Positive
EMERGING MARKETS-Latam stocks extend losses on trade concerns, growth worries	Negative
Banco Bradesco SA to acquire BAC Florida Bank	Positive
Doubts about trade deal sour markets and create new risks in week ahead	Negative
Itau Unibanco Holding reports Q1 results	Positive
Opening Bell, May 1, 2019	Neutral
Today’s Bell Ringer, May 1, 2019	Neutral
New chief vows to keep Petrobras free from political meddling	Positive
Stocks making the biggest moves midday: Pinterest, Zoom, Blackstone & more	Neutral
European markets close marginally higher amid earnings	Negative
Indonesia lifts tsunami warning after magnitude 6.8 quake off Sulawesi	Negative
Brazil to charge Vale over fatal dam collapse: WSJ	Negative
Brazil mining giant Vale will face criminal charges over deadly dam collapse: report	Negative
EMERGING MARKETS-Latam stocks fall with Argentina, Brazil sliding most	Negative
Vale under pressure to improve safety as Union sells stake	Positive
Governments could save $1 trillion in taxes by curbing corruption, new IMF research says	Positive
REFILE-EMERGING MARKETS-Latam currencies slip against strong dollar	Positive
Brazil’s Vale announces write downs, profit after dam disaster	Neutral
Stocks slip as 10-year Treasury yield hits lowest level since 2017	Negative
Watch Wednesday’s trade data to see how China conflict is affecting US trade gap	Positive
‘Trump of the Tropics’: How Brazil’s President Came to Power	Positive
Two major U.S. banks weigh stablecoin projects	Negative
Exxon and Chevron just announced big plans to surge oil and gas output from top ...	Positive
Stocks making the biggest moves premarket: Tesla, AT&T, Eli Lilly & more	Neutral
EMERGING MARKETS-Latam FX dips, Brazil's real soft as traders trim positions	Negative
Brazil's Ambev reports lower recurring net profit on higher costs	Positive
EMERGING MARKETS-Latam stocks, currencies dip; Trump-Kim meet's early end hits sentiment	Positive
Brazil's Ambev sees EBITDA in Brazil growing at a faster pace in 2019 - CFO	Positive
Rio Tinto posts best underlying earnings in four years, offloads cash	Positive
Next week will be pivotal for markets with trade ‘progress,’ Powell, Trump-Kim and more	Neutral
SLA clinches Asia deal after Japan’s Mitsubishi offloads stake	Positive
Itau Unibanco Holding reports Q4 results	Positive
The ‘Monster’ Texas Oil Field That Made the U.S. a Star in the World Market	Negative
Chevron beats profit expectations as annual oil and gas output hits record	Positive
Banco Bradesco reports Q4 results	Negative
Business leaders in Davos ‘don’t care’ if Brazil’s Bolsonaro is a populist — it’s all ...	Neutral
Bolsonaro will be remembered as ‘Thatcher of the Tropics’ if his reforms are successful, Itau ...	Positive
UPDATE 1-Brazil Carnival's beer contracts probed for competition violations	Negative
Brazil Carnival's beer contracts probed for competition violations	Negative
Stocks making the biggest moves after hours: United Airlines, Snap, Apple & more	Positive
UPDATE 4-AB InBev considers partial IPO of Asian business -bankers	Negative
AB InBev considers partial IPO of Asian business -bankers	Negative
How 3 Funds Sidestepped a Market Thumping	Neutral
AB InBev considers partial IPO of Asian business: Banker	Negative
US-China: farmers count cost of trade war	Negative
Brazil stocks broadly higher as new president makes moves	Positive
Brazil stocks, real gain in first session after Bolsonaro takes office	Positive
Banco Bradesco goes ex-dividend on Wednesday	Positive
Global markets battered in wake of Fed meeting	Neutral
Brazil's Ambev builds solar plant to power beer distribution centers	Positive
Trade war doesn’t benefit anyone, especially emerging markets: CEO	Neutral
Santander’s Roberto Campos Neto to become Brazil’s new central banker	Negative
HSBC plots return to Brazil as chief eyes growth	Positive
There will be an oil shortage in the 2020s, Goldman Sachs says	Negative
Trump Administration Spares Corporate Wrongdoers Billions in Penalties	Negative
Brazil election not a buying opportunity, instead wait to see what president does: Analyst	Positive
Brazil names shoot higher after Bolsonaro victory; Petrobas +10%	Positive
French and Benelux stocks-Factors to watch on Oct 26	Negative
Brazil's Ambev latest victim of Argentine inflation in third quarter	Negative
UPDATE 4-Brewer Ambev squeezed by Brazil competition, Argentina inflation	Negative
Stocks making the biggest moves premarket: GE, PBR, AAPL, WMT & more	Neutral
Brazil markets soar on strong first-round vote for Bolsonaro	Positive
Petrobras +14% on Bolsonaro election strength, BAML upgrade	Positive
UPDATE 5-Brazil markets soar on strong 1st-round vote for Bolsonaro	Positive
Brazil stocks, currency rally as far-right presidential candidate extends lead	Neutral
Brazil stocks rally as Bolsonaro's support rises ahead of Oct. 7 election	Positive
PRA Group in partnership with Banco Bradesco for nonperforming loan servicing	Positive
EMERGING MARKETS-Argentina stocks, peso rebound as IMF talks stir optimism	Positive
EMERGING MARKETS-Argentine equities rebound as traders seek bargains	Positive
Heineken factory caught up in Brazil land dispute	Negative
Brazil growth stalls ahead of presidential election	Positive
Brazil's Ambev plans to add 1,600 electric trucks to fleet	Positive
CORRECTED-Brazil's Ambev plans to add 1,600 electric trucks to fleet	Positive
Brazil companies mull buying trucks to avoid higher shipping fees	Positive
Heineken suffers hiccup as Brazil unit hits profits	Positive
Apple reports earnings in a hectic week for markets, with a Fed meeting and jobs ...	Positive
UPDATE 2-Brazil's Ambev shares rise after strong Q2 results	Positive
EMERGING MARKETS-Brazil stocks seesaw after flurry of corporate earnings	Negative
Ambev CFO sees challenging operating environment in Brazil	Positive
EMERGING MARKETS-LatAm stocks dip off highs after earnings reports	Positive
Brazil's Ambev misses Q2 profit estimate despite higher beer sales	Positive
BRF, Carrefour among Brazil trucking strike victims as Q2 results roll in	Negative
RPT-FOCUS-Bar by bar, Heineken battles AB Inbev in Brazil	Negative
European markets close higher as auto stocks jump 3.4%; investors monitor U.S.-China tariff deadline	Positive
Bar by bar, Heineken battles AB Inbev in Brazil	Negative
FOCUS-Bar by bar, Heineken battles AB Inbev in Brazil	Negative
Brazilian start-ups defy economic gloom	Negative
Ex-Brazil tycoon Batista handed 30-year sentence for corruption	Positive
UPDATE 1-Ex-Brazil tycoon Batista handed 30-year sentence for corruption	Negative
Brazil’s central bank faces test over currency	Negative
Petrobras plunges on reports of CEO Pedro Parente resignation	Negative
Petrobras CEO Pedro Parente has resigned from his post amid nationwide strikes	Negative
Petrobras shares plunge 20% after CEO Pedro Parente resigns amid strikes	Negative
Brazil returns to uneasy calm as protests wind down	Negative
UPDATE 4-Brazil returns to uneasy calm as protests wind down	Negative
Dow tumbles almost 400 points	Negative
Your first trade for Thursday, May 17	Positive
Bunge files prospectus for Brazilian sugar IPO	Positive
Final Trade: SLV, FL & more	Positive
Even strident populists must face Brazil’s fiscal reality	Negative
Racial diversity in Brazil ‘turns to a new page’	Positive
Grains of recovery whet appetite for fiscal reform in Brazil	Neutral
Closing Bell Ringer: May 15, 2018	Neutral
UPDATE 1-Ambev misses profit estimates on weak Brazil sales	Negative
Brazilian beverage company Ambev misses quarterly profit estimates	Positive
Stocks close little changed after Trump decides to pull US from Iran nuclear deal	Positive
Tech momentum could continue as Buffett buy helps give Apple best week since 2011	Positive
US crude sinks nearly 2% to 2-week low, settling at $67.25, as dollar surge weighs ...	Negative
Publicis rises 5% after new clients lift revenues	Positive
Megadeal puts Brazil back on M&A bankers’ radar	Positive
Vale seeks new dividend policy as debt falls	Negative
Sugar glut pushes Brazil mills into ethanol, white sugar, washouts	Positive
Value investors set to reap EM growth benefits	Positive
Argentina approves AB Inbev plan for post-merger beer divestments	Positive
‘Anarchist-capitalists’ in São Paulo shake the money box	Negative
Technology opens road to navigating São Paulo’s gridlock	Positive
Carlyle-backed Brazilian toy retailer Ri sets IPO price range	Positive
US oil at record output, and investors want companies mindful of ‘boom to bust’ spending	Positive
UPDATE 2-Brazil's Ambev projects 2018 margin growth after solid quarter	Positive
Brazil's AmBev misses quarterly profit estimates	Positive
Asia to rise to 75% of EM index in planned revamp Premium	Positive
Stocks making the biggest moves after hours: LULU, CRUS & SWKS	Neutral
Brazil’s second-biggest non-state bank names new CEO	Positive
Bradesco executives charged with corruption in Brazil	Negative
Petrobras executive director: We have made progress on governance	Positive
Scandal-hit Brazilian oil giant promises dividend as soon as it returns to profit	Positive
Bulls head abroad & a trade update on this oil name	Neutral
Bulls are long for this energy stock	Positive
Brazil’s economy has recovered quite well, Itau’s Marino says	Positive
Asia becomes key market for dollar bond sellers	Negative
Brazil remains priced for perfection	Positive
Quest for new oil discoveries still on back burner	Positive
Here are the 10 most important stories for investors Wednesday morning	Positive
Brazil’s Petrobras to pay $2.95 billion to settle US class action lawsuit over corruption	Negative
Brazil's Petros pension fund sells 5.7 pct of Itaúsa	Neutral
BT appoints new general counsel	Positive
Brazilian shoppers help buoy nascent recovery	Positive
Petrobras CEO Parente talks earnings, attempting to gauge oil pricing	Positive
Petrobras CEO: We see $55-$65 oil in the medium term	Positive
Petrobras CEO says cheaper offshore oil puts Brazil on the ‘winner’s side’ of a tough ...	Positive
Temer’s Brazil was mistakenly priced for perfection	Positive
Brazil's Previ plans more diversified stock portfolio -Estado	Positive
Oil could top $200 if Saudi-Iran war breaks out	Negative
UPDATE 1-Ambev results mixed on higher pricing, weak volumes	Negative
Brazil's Ambev beats Q3 profit estimates	Positive
Itaú Unibanco CEO readies for fintech battle	Negative
Brazil investors wish for a privatisation carnival	Positive
Fitch Affirms The Central America Bottling Corp. at 'BB+'; Outlook Stable	Neutral
Opening Bell, October 2, 2107	Neutral
Today’s Bell Ringer, October 2, 2017	Neutral
A cool head for crisis: Ilan Goldfajn	Negative
Brazil former presidents Lula and Rousseff charged in corruption case	Negative
Major refineries are shutting down in the wake of Harvey flooding	Neutral
Major Texas refineries remain closed, reduce activity as Harvey batters Gulf Coast	Positive
Asian stocks close mixed as oil markets digest Hurricane Harvey impact; euro near 2-1/2 year ...	Positive
Bumpy times in Brazil, but hedge funds boom	Positive
Fintechs target Brazilian banks’ fat margins	Positive
JBS puts meat on listings rebound in Brazil	Positive
Why one investor is actually bullish on Brazil’s troubled state oil giant Petrobras	Neutral
Outlook for Venezuelan debt market a function of political process: Amundi	Negative
August’s dog days will be anything but for Wall Street with big earnings, economic data ...	Positive
Wall Street set to open higher as earnings dominate trading	Positive
Carrefour’s Brazil Unit Prices I.P.O. at Low End of Range	Neutral
Brazil’s J&F sells Havaianas maker for $1.1 bln	Positive
CEOs failed to champion climate change report	Positive
EMERGING MARKETS-Brazil markets down on political woes; power utilities soar	Positive
EMERGING MARKETS-Brazil markets dip, Mexican rate swap yields rise	Negative
Brazil investors stoic against political turmoil	Negative
EMERGING MARKETS-Brazil markets down after Temer charged with corruption	Negative
Vale moves to limit Brazil government’s influence	Positive
Havaianas flip-flop maker to be sold as scandal-hit owner looks to raise funds	Positive
Breaking boundaries: the 2017 FT Global GC 20	Negative
Goldman Sachs lowers oil price projections on potential shale surge	Positive
Culture of corruption engulfs Brazilian elite	Positive
EMERGING MARKETS-Brazil stocks rebound on bargain hunting; political woes linger	Negative
S&P puts 38 Brazilian financial institutions’ ratings on negative watch	Negative
There’s 100% chance that Brazil’s President Michel Temer will leave before end of mandate: Analyst	Positive
Brazil slowly developing into a fintech powerhouse as political scandal swirls	Negative
Brazilian stocks rebound as political turmoil rumbles on	Neutral
Brazil stocks plunge on emerging political scandal, post worst day since 2008	Negative
If oil prices recover, these stocks may become attractive	Positive
Brazil president taped discussing pay-off for witness in graft probe-O Globo	Positive
Goldman Sachs sees big potential for fintech in Brazil	Positive
São Paulo’s talent for renewal is paying off	Positive
Goldman Sachs Sees Big Potential for Fintech in Brazil	Positive
BNDES overhauls lending	Negative
Reforms end three years of turmoil and recession in Brazil	Negative
Brazil ex-President Lula calls graft case a ‘farce’ in fiery defence	Negative
The lean and mean approach of 3G Capital	Negative
Brazil takes step closer to pensions overhaul	Negative
Brazil's Ambev misses estimates as cost pressure bites	Negative
UPDATE 3-Ambev sees cost pressure easing in weak Brazil market	Negative
Ambev's Paiva pledges to curb expenses, bolster premium brands	Neutral
Opening Bell, May 3, 2017	Neutral
Today’s Bell Ringer, May 3, 2017	Neutral
Temer pushes labour reforms despite backlash	Negative
Azul float raises hopes for Brazil’s stalled IPO market	Positive
Brazil cuts interest rates as inflation nears target	Positive
Ousted Brazilian President Dilma Rousseff: I was the victim of a coup	Negative
Azul, shareholders fetch $645 million in bigger-than-expected Brazil, US IPO	Positive
Vale turns to experienced Brazilian manager in Schvartsman	Positive
Vale appoints local industry insider as new CEO	Positive
Tencent pushes past Alibaba as biggest EM stock	Positive
Futures suggest a higher open on Wall Street as oil prices rebound	Positive
Brazil strives to quell meat scandal as Hong Kong bans imports	Negative
3 reasons Latin American stocks will continue to soar	Positive
Stocks close mixed in choppy session after deluge of Fed speakers	Negative
This foursome could be the most exciting event for markets Tuesday	Positive
Scandal roils Brazil meat sector; China, EU, S. Korea suspend imports	Negative
Brazil to emerge from recession by year end	Negative
This is why Washington wrangling could become a bigger deal in the week ahead	Negative
Cautious Optimism in Brazil as Appetite Returns for I.P.O.s	Positive
Petrobras CEO: This strategic plan will reduce debt by half	Positive
Search for new chief heightens concerns at Vale	Neutral
Economic situation in Brazil is improving: Pro	Positive
UPDATE 2-AB InBev suffers first core profit decline on Brazil slump	Negative
AB InBev suffers first core profit decline on Brazil slump	Negative
EMERGING MARKETS-LatAm stocks, currencies drop on bets of U.S. rate hike	Negative
UPDATE 2-Weak Brazil beer sales hit Ambev earnings, shares down	Positive
Brazil's Ambev posts $1.6 bln net income in fourth quarter	Neutral
Dow closes above 21,000 as stocks post best day of 2017 after Trump’s speech	Positive
Dow snaps 12-day winning streak ahead of Trump’s speech to Congress	Positive
Dow notches 12th straight record close as Wall Street braces for Trump speech	Positive
There’s a big week ahead, and what President Trump tells Congress could be a huge ...	Positive
Cramer’s 4 big reasons stocks are rallying (Hint: They have nothing to do with Trump)	Positive
Cramer Remix: How Garmin could outrun Fitbit	Neutral
Why stocks are rallying, and it isn’t Trump: Cramer	Positive
Breakingviews: The race is on to be the SABMiller of food	Positive
Food Industry May Follow the Brewers’ Merger Frenzy	Negative
The race is on to be the SABMiller of food	Positive
Vale welcomes moves to end investors’ power pact	Positive
Vale to dissolve shareholder agreement	Positive
UPDATE 3-Heineken takes battle to AB InBev in Brazil with $1 bln Kirin deal	Negative
Heineken takes battle to AB InBev in Brazil with $1 billion Kirin deal	Negative
Banks Look to Cellphones to Replace A.T.M. Cards	Negative
Brazil's former richest man to stand trial on corruption charges	Positive
UPDATE 1-Brazil's former richest man to stand trial on corruption charges	Positive
Brazil's former richest man Batista faces corruption charges	Positive
Early movers: MYL, LMT, GD, GPOR, AMZN, WMT, PBR & more	Neutral
Futures point to positive end to 2016 as billions pour into stocks	Positive
Cramer’s lightning round: Why this stock is the ‘First National Bank of Trump’	Positive
DST Global Leads $80 Million Private Investment in Nubank	Positive
Plane carrying Brazil’s Chapecoense soccer team crashes in Colombia	Positive
Brazil firms lean on FX, debt dynamics as slump lingers	Negative
Brazil anti-government protesters occupy Congress, call for coup	Negative
US crude settles down 9 cents at $43.32 as traders fear another year of glut	Negative
Petrobras asset sales fuel Brazilian M&A revival	Positive
Dow ripping to new highs on Donald Trump presidency	Positive
Dow rips to all time high as investors embrace Trump presidency	Positive
Fitch Downgrades Anheuseur-Busch InBev to 'BBB'; Withdraws SABMiller	Negative
HSBC ready to put more capital in investment bank	Positive
EMERGING MARKETS-Latam currencies seesaw on U.S. election uncertainty	Negative
UPDATE 2-UK Stocks-Factors to watch on Nov 2	Negative
UK Stocks-Factors to watch on Nov 2	Positive
BRIEF-Kirin Holdings unit Brasil Kirin Holdings S. A. to sell Cachoeiras de Macacu Bebidas Ltda at about 14.6 bln yen	Negative
Exclusive: Coca-Cola, Ambev eye Brazil juice maker, sources say	Positive
EMERGING MARKETS-Brazil stocks rise; Usiminas soars on smaller quarterly loss	Negative
UPDATE 1-Ambev cuts guidance as Brazil recession weighs on beer sales	Negative
AmBev cuts guidance as Brazil recession weighs on beer sales	Negative
US stocks futures tick higher after stronger-than-expected GDP data	Negative
Stocks close lower after global bonds sell-off; real estate slides 2%	Negative
Dow closes higher as Boeing gains offset Apple’s fall; financials lead	Positive
Stocks close lower after mixed earnings results; consumer stocks fall 1%	Negative
Stocks close higher amid earnings, M&A activity but dollar and oil cap gains	Neutral
Busiest day for earnings, GDP and more coming in the next week	Negative
Rio rebooted: why luxury brands are buying in to the city	Positive
Brazil soft drinks production was weakest September since 2011	Negative
Tim Seymour on how to invest in emerging markets	Neutral
AB InBev to retain its name after SABMiller takeover	Positive
RPT-UPDATE 1-Hungry Nomad Foods ready to start M&A shopping again	Positive
UPDATE 1-Hungry Nomad Foods ready to start M&A shopping again	Positive
Hungry Nomad Foods ready to start M&A shopping again	Positive
Why HSBC chose to move on from being ‘the world’s local bank’	Positive
No prizes for runner up in Brics race	Positive
HSBC Q2 profits fall as $2.5bn buyback announced	Positive
HSBC plans two major share buybacks after profits drop	Positive
HSBC second-quarter profit slides 45%	Positive
BoE eases EU banks’ post-Brexit fears	Negative
UPDATE 2-Ambev profit misses, Brazil revenue outlook flat; shares fall	Positive
Brazil's Ambev reports 18 pct drop in 2nd quarter profit	Positive
Brazil's Ambev to launch returnable bottles campaign to raise sales	Positive
Ambev profit misses, Brazil revenue outlook flat; shares fall	Positive
Rio 2016: Is Brazil doing the Olympics on the cheap?	Positive
EMERGING MARKETS-Latam stocks, currencies seesaw on U.S., China data	Positive
HSBC completes Brazilian sales	Positive
Brazil beer production in June falls to 2012 levels	Positive
EU probes AB InBev’s practices in home market	Negative
AB InBev faces antitrust probe in Belgium	Negative
Brazil oil research park woos L'Oreal, Inbev as petro-market slips	Positive
Zelotes: Brazil’s ‘other’ corruption probe	Negative
Brazil probe means a boom for lawyers	Positive
EMERGING MARKETS-Latam stocks, currencies down for 4th day on Brexit jitters	Positive
Spain’s big banks stay committed to Latam Premium	Positive
Reversal of fortune raises Latam stakes Premium	Negative
Bradesco CEO indicted in Brazil	Positive
EMERGING MARKETS-Latam currencies slip ahead of Yellen speech	Negative
AB InBev shuffles Latin American assets	Negative
Investors boost bets on post-Rousseff Brazil but doubts persist	Negative
Brazil's Ambev passes Peru, Colombia, Ecuador ops to AB InBev	Negative
Investors boost bets on post-Rousseff Brazil, long-term doubts persist	Positive
UPDATE 1-Investors boost bets on post-Rousseff Brazil but doubts persist	Negative
Fitch Downgrades ABI to 'BBB+'; Rating Watch Negative	Negative
U.S. RESEARCH ROUNDUP-Cirrus Logic, Lumentum Holdings, Scorpio Bulkers	Positive
Charles Brandes: 4 ways to make money now from value investing	Positive
AB InBev profits disappoint due to Brazil	Negative
HSBC’s Profit Down 18% as Markets Weigh on Results	Positive
HSBC: blend until bland	Neutral
Brazilian banks’ bad loan problem	Negative
Big pharma dominates ranking of stocks with best five-year returns	Positive
Deals of the day- Mergers and acquisitions	Neutral
Brazil's Ambev to acquire local juice producer Do Bem	Positive
UPDATE 1-Brazil's Ambev to acquire local juice producer Do Bem	Positive
Brazilian equities: swinging	Positive
Roger Agnelli, mining executive, 1959-2016	Positive
Roger Agnelli, ‘Iron Man’ Who Led a Global Mining Giant, Dies at 56	Positive
After Living Brazil’s Dream, Family Confronts Microcephaly and Economic Crisis	Negative
HSBC dividend rise seen as unsustainable	Negative
EMERGING MARKETS-Brazil real seesaws ahead of Carnaval; U.S. job data weighs	Negative
Brazil’s equity market: still without a pulse	Negative
Fitch Publishes Latin America Quarterly Beverage Trends for 3Q'15	Neutral
Rising bad loans at Itau spark Brazil bank rout	Positive
The only way to play emerging markets that won’t crush you	Positive
LatAm cost cuts key to AB InBev/SABMiller Premium	Negative
Fitch Rates Anheuser-Busch InBev's Bond 'A RWN(EXP)'	Negative
Brazil to drag Kirin to first annual loss	Negative
Your first trade for Friday, December 18	Positive
Coffee deal spotlights reclusive Reimanns	Positive
Fitch Maintains Anheuser-Busch InBev & SABMiller plc on RWN	Negative
Glimmers amid the economic gloom in Brazil	Negative
InBev's Brazil unit buys Canadian beer, cider brands for $350 mln	Positive
InBev's Brazil unit buys Canadian beer, cider brands for $350 million	Positive
HSBC chief’s losing streak continues	Negative
Specialist insurers make good progress	Positive
EMERGING MARKETS-Latam currencies, stocks gain ahead of Fed decision	Positive
Fitch Publishes Latin America Quarterly Beverage Trends for 2Q'15	Neutral
Champagne on ice for AB InBev’s Megabrew	Neutral
MegaKega? Megabrew? Beer merger plans launch corporate name game	Positive
Anheuser-Busch InBev and SABMiller to Join	Positive
3G founder is thirsty for beer dominance	Positive
The Family That May Hold the Key to a Beer Deal	Positive
Fitch Places Anheuser-Busch InBev and SABMiller plc on Rating Watch Negative	Negative
Timeline: SABMiller would be culmination of years of deals for AB Inbev	Negative
TIMELINE-SABMiller would be culmination of years of deals for AB Inbev	Negative
Fitch Updates Scenario Analysis of ABI/SABMiller Combination	Negative
Slowdown hits spending power	Positive
LatAm companies seek markets further afield	Positive
Big Beer Deals	Positive
Fitch: ABI Could Face Multi-Notch Downgrade From SABMiller Deal	Negative
AB InBev approaches SABMiller over tie-up	Negative
The Brazilians Behind the Consolidation in Beer	Positive
Anheuser-Busch InBev Approaches SABMiller on Possible Takeover	Positive
China falters, and the global economy is forced to adapt	Negative
HSBC H1 adjusted pre-tax profit up 2% at $13BN	Positive
AB InBev unit Ambev buys Brazilian craft brewer Colorado	Positive
AB InBev’s hard-nosed kings of beer	Negative
RPT-Brazil soccer probe to put harsh glare on Nike, other sponsors	Negative
Brazil soccer probe to put harsh glare on Nike, other sponsors	Negative
Whirlpool and AB InBev team up on hot-and-cold drink machine	Positive
Jorge Paulo Lemann, a lean, hungry mogul	Positive
AB InBev to appoint JAB chief as chairman	Negative
Ruthless operating focus behind 3G rise	Neutral
3G Capital, Warren Buffett’s Favorite Partner in Deals Worth Billions	Positive
Companies diary: February 23 - February 27	Negative
UPDATE 1-Verde hedge fund expects repricing of Brazil assets, especially currency	Neutral
Verde hedge fund expects repricing of Brazil assets, especially currency	Positive
BNDES: Tycoons’ lender of first resort	Neutral
Fitch Publishes Ratings Navigator for 9 Alcoholic Beverages Companies	Negative
Fitch Affirms Anheuser Busch InBev at 'A'; Outlook Stable	Positive
Fitch Upgrades SABMiller to 'A-'; Outlook Stable	Positive
Brazil's Neves closing campaign cash gap thanks to banks and ethanol	Positive
Responsible drinking—beyond the bartender	Positive
Brazilian sentiment sours as Rousseff widens lead	Positive
Lightning Round: Home Depot, Coca-Cola & more	Positive
Market driving Cramer to drink, really	Neutral
UPDATE 1-Brazil to delay tax hike on beverages -industry official	Negative
Fitch: Combined ABI/SABMiller Could Remain Investment Grade	Positive
Fitch: Rating Impact of a Combined ABI-SABM	Negative
Dow, S&P 500 end lower following drop in energy shares	Neutral
US STOCKS-Dow, S&P 500 end lower following drop in energy shares	Neutral
STXNEWS LATAM-Petrobras market cap beats Ambev, regains top Brazil spot	Negative
Banco Espirito Santo’s Brazil play poses warning for other EU banks	Negative
World Cup Revelry Overwhelms Beloved Neighborhood in São Paulo	Positive
Portugal’s BES hits back–should we blame the parent?	Negative
AB InBev thirsty for growth in Asia, but Africa less promising -CEO	Positive
Even if Brazil wins World Cup, it loses: Bankers	Positive
COLUMN-The score on Brazil as a long-term investment	Positive
The score on Brazil as a long-term investment	Positive
Brazil’s companies need soccer team’s global clout	Neutral
BG falls as analysts play down sale	Positive
Brazil stocks poised for World Cup boost	Positive
Eyeing elections, drought-hit Sao Paulo resists water rationing	Neutral
EMERGING MARKETS-Latam stocks follow global rise; currencies up on U.S. data	Negative
World Cup boost for Brazil? Don’t bet on it	Positive
U.S./Canada daily earnings hits & misses May 7 - 1800 ET	Negative
EMERGING MARKETS-Brazil stocks fall with Ambev; mining shares drop	Negative
The bank of the future	Neutral
Will beer tax rise be a Brazilian own goal?	Positive
Truck maker MAN wins orders from Brazil	Positive
Mondelez unveils new cost-cutting strategy	Positive
Emerging markets selloff bruises big-name funds	Neutral
Analysis: Emerging markets selloff bruises big-name funds	Negative
World Cup fails to lift Brazilian stocks	Positive
RPT-Fitch Affirms Anheuser Busch InBev at 'A' on Oriental Brewery Acquisition	Positive
Brazil acquires taste for premium beer	Positive
Challenging year forces Brazil to rethink	Positive
Brazil stocks rise on improving German, U.S. data	Positive
EMERGING MARKETS-Brazil stocks rise on improving German, U.S. data	Neutral
Analysis: Brazilian companies cut back to protect profit, trim debt	Positive
Companies beach tax bills in Spanish shells	Negative
RPT-Fitch affirms Anheuser Busch InBev at 'A'; outlook stable	Positive
CORRECTED-RESEARCH ALERT-Souza Cruz: JP Morgan raises to overweight (Aug 12)	Neutral
Ação da Ambev após resultado do 2º trimestre	Positive
$15 tickets to soccer’s World Cup? Only if you’re Brazilian	Positive
The Best Market Outside the US: Pro	Positive
Your First Move for Tuesday, June 25	Positive
Multilatinas: moving up the ranks	Positive
Brazil investors look beyond benchmark	Positive
RPT-Fitch: More Consumer Firms to Follow PMI With Minority Buy-Outs	Neutral
Analysis: Consumer stocks shine in emerging market profit gloom	Neutral
STXNEWS LATAM-Bofa sees Ambev's share merger adding 12 pct to EPS	Positive
The New Billion Dollar Retail Democracy	Neutral
EMERGING MARKETS-Brazil stocks mixed on first-quarter earnings	Positive
AB InBev: losing its fizz in Brazil	Negative
Invest Like a Drunk: 5 Booze Stocks to Buy in 2013	Positive
COLUMN-Catch a falling BRIC and put it in your pocket	Positive
Brazil's Ambev says exit from Venezuela limited to plant closure	Negative
Beer maker Brahma shuts Venezuela plant on sales slide	Negative
Ambev sees unit costs up this year on currency, higher taxes	Positive
Are We in Danger of a Beer Monopoly?	Negative
The Week Ahead: February 25 - March 3	Negative
RPT-Buffett deal for Heinz a wake-up call to food industry	Positive
Buffett deal for Heinz a wake-up call to food industry	Positive
Heinz deal puts 3G in limelight	Positive
After Heinz, a Brazilian invasion? Not so quick	Positive
AB InBev setback may hasten last round of beer M&A	Negative
TEXT-Fitch rates Anheuser-Busch InBev's USD4bn issues at 'A'	Neutral
Soccer-Brazil league bets big on season ticket plan	Positive
Analysis: Brazil's once-envied energy matrix a victim of "hubris"	Neutral
Petrobras CEO says fuel imports rising; awaits price increase-Globo	Positive
TEXT-Fitch affirms Embotelladora Andina ratings at 'A'	Neutral
EMERGING MARKETS-Brazil stocks in modest gains, Mexico flat	Positive
Ambev to restructure shares at Sao Paulo stock exchange - filing	Positive
TEXT-S&P summary: Anheuser-Busch InBev N.V./S.A.	Positive
UPDATE 4-Santander Brasil sees “new normal” for Brazil banks in two years	Negative
UPDATE 2-Profit at Santander Brasil slumps on higher provisions	Neutral
UPDATE 5-Santander Brasil sees ‘new normal’ for Brazil banks	Negative
UPDATE 4-Brazil’s Ita+¦ sees expense cuts as way to stem slide	Negative
TEXT-S&P publishes peer comparison on global brewers	Positive
UPDATE 1-Machinists go on strike at Bombardier Learjet in Kansas	Negative
Machinists go on strike at Bombardier Learjet in Kansas	Negative
Lufthansa wants more buying power with plane makers	Positive
UPDATE 1-SNC-Lavalin picked to build Vancouver-area light rail line	Neutral
BRIEF-Bombardier secures orders for six global business jets	Positive
UPDATE 2-Qatar won’t take Boeing 787s until engine fault fixed	Negative
UPDATE 1-Qatar won’t take Boeing 787s until engine fault fixed	Negative
Qatar Airways CEO backs BAE, EADS merger; eyes Bombardier jets	Positive
CANADA STOCKS-TSX may open higher; weak data fuels stimulus hope	Positive
BRIEF-Bombardier rail control technology on board Mass Rapid Transit in Malaysia	Positive
Bombardier signs $64 mln train contract with Deutsche Bahn	Neutral
BRIEF-Bombardier to deliver 5 windexx vario multiple units to Deutsche Bahn	Negative
UPDATE 1-Bombardier wins $156 mln contracts in Germany, Malaysia	Positive
Owner of Labatt USA, Genesee beer seeks buyer-sources	Positive
ADR REPORT-ADRs edge up but LatAm shares fall 1 pct	Positive
Bulls Are Thirsty for Ambev	Neutral
Cramer: Why You Should Still Care About Stocks	Positive
TEXT-Fitch affirms Compania Cervecerias Unidas ratings	Negative
TEXT-S&P raises Cerveceria Nacional Dominicana S.A. ratings	Negative
TEXT-S&P raises AmBev rating to 'A'	Neutral
UPDATE 3-AB InBev in talks to buy rest of Modelo-source	Positive
TEXT-Fitch: Anheuser's full control of Modelo makes sense	Positive
ADR REPORT-ADRs fall, led by losses in LatAm shares	Negative
Slow and steady Mexico draws equity bets over Brazil	Positive
Analysis: Slow and steady Mexico draws equity bets over Brazil	Positive
TEXT-Fitch ups Anheuser Busch InBev SA/NV to 'A';otlk stbl	Neutral
TEXT-Fitch raises Ambev ratings to 'A'	Neutral
TEXT-S&P upgrades Cerveceria Nacional Dominicana to B+; On Watch Pos	Positive
BRIEF-Moody's comments on Ambev's strategic alliance in the Caribbean.	Positive
TEXT-Fitch on Anheuser Busch InBev	Neutral
UPDATE 4-AmBev to buy control of Dominican brewer CND	Negative
AmBev to pay $1 bln for stake in Caribbean brewer	Positive
TEXT-Fitch says Ambev acquisition a strategic positive	Positive
TEXT-S&P: AmBev ratings unaffected by CND acquisition	Positive
AmBev to buy control of Dominican brewer CND	Positive
AB InBev lead bidder for Dominican brewer - WSJ	Positive
Economic stimulus to help Brazil industrial stocks	Positive
CORRECTED-TEXT-S&P revises Molson Coors outlook to negative	Negative
UPDATE 1-Economic stimulus to help Brazil industrial stocks	Positive
How to Ride Brazil’s 2012 Rally	Positive
Soccer-FIFA tells Brazil it must have beer at World Cup	Positive
Do Emerging Markets Offer Shelter From EU Storm?	Positive
Navellier: Four Stocks To Defy DC	Negative
12 Best Value Plays For Investors: Strategists	Positive
6 Expensive Stocks Worth Buying: Contrarian Strategy	Positive
5 Buys on Brazil’s Rising Middle Class	Positive
Your First Move For Tuesday March 23rd	Positive
Week Ahead: Stocks Search for Catalyst in Quiet Week	Positive
Betting On Sin: Beer, Diabetes, Tobacco	Negative